border_size=1
usage=map

Xu          , Xu          , Xu          , Xu          , Xu          , Xu          , Xu          , Ql          , Ql          , Ql          , Xu          , Xu          , Xu          , Xu          , Xu          , Ql          , Xu          , Ql          , Ql          , Ql          , Ql          , Xu          , Xu          , Xu          , Xu          , Xu          , Xu          , Xu          , Xu          , Xu          , Xu          , Xu          
Xu          , Xu          , Xu          , Xu          , Xu          , Xu          , Xu          , Xu          , Xu          , Xu          , Ql          , Ql          , Xu          , Ql          , Xu          , Ql          , Xu          , Ql          , Ql          , Ql          , Ql          , Ql          , Ql          , Ql          , Ql          , Xu          , Xu          , Xu          , Xu          , Xu          , Xu          , Xu          
Xu          , Xu          , Xu          , Xu          , Xu          , Xu          , Xu          , Xu          , Ql          , Ql          , Ql          , Ql          , Ql          , Ql          , Xu          , Xu          , Ql          , Xu          , Xu          , Ql          , Ql          , Ql          , Ql          , Ql          , Ql          , Ql          , Ql          , Xu          , Ql          , Xu          , Xu          , Xu          
Xu          , Xu          , Xu          , Xu          , Xu          , Xu          , Ql          , Ql          , Ql          , Ql          , Uu          , Ql          , Ql          , Xu          , Xu          , Xu          , Uu^Vu       , Uu          , Xu          , Xu          , Xu          , Ql          , Ql          , Ql          , Ql          , Ql          , Ql          , Ql          , Ql          , Xu          , Ql          , Xu          
Xu          , Xu          , Xu          , Xu          , Ql          , Xu          , Xu          , Ql          , Ql          , Uu          , Uu          , Ql          , Ql          , Xu          , Ql          , Cud         , 5 Kud       , Cud         , Uu^Vu       , Xu          , Ql          , Ql          , Uu          , Uu          , Ql          , Ql          , Ql          , Ql          , Ql          , Ql          , Ql          , Xu          
Xu          , Xu          , Ql          , Ql          , Ql          , Xu          , Xu          , Ql          , Ql          , Uu          , Uh          , Uh          , Uu          , Xu          , Uu^Vu       , Cud         , Uu^Vu       , Cud         , Uu^Vu       , Uu          , Uu          , Uu          , Uu          , Uu          , Ql          , Ql          , Ql          , Ql          , Ql          , Ql          , Ql          , Ql          
Xu          , Xu          , Ql          , Ql          , Ql          , Xu          , Ql          , Ql          , Ql          , Uu          , Uh          , Uh          , Uh          , Uu          , Uu          , Ql          , Ql          , Uu          , Uu          , Qlf         , Qlf         , Qlf         , Uu          , Uu          , Uu          , Ql          , Uu          , Ql          , Ql          , Ql          , Ql          , Xu          
Xu          , Xu          , Xu          , Ql          , Ql          , Xu          , Ql          , Ql          , Ql          , Ql          , Ql          , Uu          , Uu          , Uh          , Ql          , Uu          , Uu          , Uu          , Ql          , Uu          , Uu          , Uu          , Ql          , Uu          , Uu          , Uu          , Ql          , Ql          , Ql          , Ql          , Xu          , Xu          
Ql          , Xu          , Xu          , Xu          , Ql          , Ql          , Ql          , Ql          , Ql          , Ql          , Ql          , Ql          , Uu          , Uu          , Ql          , Ql          , Ql          , Uu          , Ql^Bs\      , Ql          , Ql          , Ql^Bs\      , Uu          , Uu          , Uu          , Uu          , Ql          , Ql          , Xu          , Xu          , Xu          , Xu          
Ql          , Ql          , Ql          , Ql          , Ql          , Ql          , Ql          , Ql          , Ql          , Ql          , Uu          , Ql          , Ql          , Ql          , Ql          , Ql          , Ql          , Ql          , Ql          , Uu          , Uu          , Uu          , Uu          , Ql          , Ql          , Ql          , Uu          , Ql          , Xu          , Xu          , Xu          , Xu          
Ql          , Ql          , Ql          , Ql          , Ql          , Ql          , Uu          , Uh          , Uh          , Uh          , Uu^Vu       , Uu          , Ql          , Ql          , Ql          , Ql          , Ql          , Ql          , Ql          , Ql          , Ql          , Uu          , Ql          , Uu          , Uu          , Uu          , Uu          , Uu          , Ql          , Xu          , Xu          , Xu          
Ql          , Ql          , Ql          , Ql          , Ql          , Ql          , Uu          , Uh          , Cud         , Uh          , Uh          , Uu          , Uu          , Uu          , Ql^Bs\      , Ql          , Uu          , Ql          , Uu          , Uu          , Uu          , Ql          , Ql          , Uu          , Ql          , Uu          , Ql          , Uu          , Ql          , Xu          , Xu          , Xu          
Ql          , Ql          , Ql          , Ql          , Ql          , Ql          , Uu          , Uu^Vu       , 3 Kud       , Uu^Vu       , Uu          , Uh          , Uh          , Uh          , Ql          , Uu          , Uu          , Uu          , Uu          , Uu          , Uu          , Ql^Bs\      , Uu          , Uu          , 4 Kud       , Cud         , Uh          , Uu          , Uu          , Xu          , Xu          , Xu          
Ql          , Ql          , Ql          , Ql          , Xu          , Ql          , Uu          , Cud         , Uu          , Cud         , Uu          , Uh          , Uh          , Uu          , Ql^Bs/      , Uu          , Uu          , Uu          , Uh          , Uh          , Uh          , Ql          , Uu          , Cud         , Uu          , Uu          , Uh          , Uh          , Ql          , Xu          , Xu          , Xu          
Ql          , Ql          , Xu          , Xu          , Xu          , Ql          , Ql          , Ql          , Ql          , Uu          , Uu          , Uh          , Uu          , Uu          , Ql          , Ql          , Ql          , Uu          , Uh          , Uh          , Uh          , Ql^Bs/      , Ql          , Uu          , Ql          , Uu          , Ql          , Ql          , Xu          , Xu          , Xu          , Xu          
Ql          , Ql          , Xu          , Xu          , Xu          , Ql          , Ql          , Ql          , Ql          , Ql          , Uu          , Uu          , Ql          , Uu          , Uu          , Ql          , Ql          , Ql          , Ql          , Uu          , Ql          , Ql          , Ql          , Ql          , Ql          , Ql          , Ql          , Xu          , Xu          , Ql          , Xu          , Xu          
Xu          , Xu          , Xu          , Xu          , Ql          , Xu          , Xu          , Xu          , Xu          , Ql          , Uu          , Uu          , Ql^Bs/      , Uu          , Uu          , Uu          , Ql          , Ql          , Ql          , Ql          , Ql          , Ql          , Ql          , Ql          , Ql          , Ql          , Ql          , Xu          , Ql          , Ql          , Ql          , Xu          
Xu          , Xu          , Xu          , Ql          , Xu          , Xu          , Xu          , Xu          , Xu          , Xu          , Ql          , Uu          , Ql          , Uu          , Ql          , Ql^Bs|      , Ql          , Ql          , Uu          , Ql          , Uu          , Uu          , Uu          , Uu          , Uu          , Ql          , Ql          , Ql          , Ql          , Ql          , Ql          , Xu          
Xu          , Xu          , Xu          , Xu          , Xu          , Xu          , Xu          , Xu          , Xu          , Xu          , Ql          , Ql^Bs|      , Ql          , Ql          , Uu          , Uu          , Uu          , Uu          , Uu          , Uu          , Uu^Vu       , Uu          , Ql          , Uu^Vu       , Uh          , Uh          , Ql          , Ql          , Ql          , Ql          , Ql          , Xu          
Xu          , Xu          , Xu          , Xu          , Ql          , Ql          , Ql          , Xu          , Xu          , Xu          , Uu          , Uu          , Uu          , Ql          , Uu          , Uu          , Cud         , Ql          , Ql^Bs/      , Uu          , Uu          , Uh          , Uh          , Uu          , Xu          , Uh          , Uh          , Ql          , Ql          , Ql          , Ql          , Xu          
Xu          , Xu          , Ql          , Ql          , Ql          , Ql          , Ql          , Ql          , Xu          , Xu          , Xu          , Uu          , Uu          , Uu          , Ql          , Cud         , 2 Kud       , Cud         , Ql          , Ql          , Uu          , Uh          , Xu          , Uu^Vu       , Xu          , Uh          , Xu          , Xu          , Ql          , Ql          , Ql          , Xu          
Xu          , Ql          , Ql          , Ql          , Ql          , Ql          , Ql          , Ql          , Ql          , Xu          , Xu          , Uu^Vu       , Ql          , Uu          , Ql^Bs/      , Cud         , Cud         , Cud         , Ql^Bs\      , Uu          , Uu^Vu       , Uh          , Uu          , Xu          , Xu          , Xu          , Xu          , Ql          , Uu          , Uu          , Xu          , Xu          
Xu          , Xu          , Ql          , Ql          , Ql          , Ql          , Xu          , Ql          , Ql          , Xu          , Ql          , Xu          , Ql          , Uu          , Uu          , Ql          , Ql^Bs|      , Ql          , Uu          , Uu          , Uu          , Xu          , Uu          , Xu          , Uu          , Xu          , Xu          , Uu          , Xu          , Xu          , Xu          , Xu          
Xu          , Xu          , Xu          , Ql          , Ql          , Ql          , Xu          , Xu          , Ql          , Ql          , Ql          , Ql          , Ql          , Ql          , Uu          , Ql          , Uu          , Ql          , Uu          , Uu          , Xu          , Xu          , Xu          , Uu          , Uu          , Uu          , Uu          , Uu          , Xu          , Xu          , Xu          , Xu          
Xu          , Xu          , Xu          , Ql          , Xu          , Xu          , Xu          , Xu          , Xu          , Ql          , Ql          , Ql          , Ql          , Ql          , Ql          , Uu          , Uh          , Uu          , Uh          , Ql          , Ql          , Ql          , Ql          , Ql          , Ql          , Uu          , Uu          , Ql          , Xu          , Xu          , Xu          , Xu          
Xu          , Xu          , Xu          , Ql          , Ql          , Ql          , Xu          , Ql          , Xu          , Xu          , Xu          , Xu          , Xu          , Ql          , Uu          , Uu          , Uu          , Uh          , Uu^Vu       , Ql          , Ql          , Ql          , Ql          , Ql          , Ql          , Uu          , Xu          , Uu          , Xu          , Xu          , Xu          , Xu          
Xu          , Xu          , Xu          , Xu          , Ql          , Xu          , Ql          , Ql          , Xu          , Xu          , Xu          , Ql          , Ql          , Ql          , Uu          , Uu          , Uu          , Uu          , Ql          , Ql          , Ql          , Ql          , Ql          , Ql          , Ql          , Xu          , Xu          , Xu          , Xu          , Xu          , Xu          , Xu          
Xu          , Xu          , Xu          , Xu          , Ql          , Ql          , Ql          , Xu          , Xu          , Xu          , Ql          , Ql          , Ql          , Ql          , Uu          , Uu          , Uu          , Uu          , Ql          , Ql          , Ql          , Ql          , Ql          , Ql          , Ql          , Ql          , Ql          , Xu          , Xu          , Xu          , Xu          , Xu          
Xu          , Xu          , Xu          , Xu          , Xu          , Ql          , Ql          , Ql          , Ql          , Ql          , Ql          , Ql          , Ql          , Ql          , Ql          , Uu          , Ql          , Ql          , Ql          , Ql          , Ql          , Ql          , Ql          , Ql          , Ql          , Ql          , Ql          , Xu          , Xu          , Xu          , Xu          , Xu          
Xu          , Xu          , Xu          , Xu          , Xu          , Xu          , Xu          , Ql          , Ql          , Xu          , Ql          , Ql          , Uu          , Uu          , Uu          , Ql          , Uu          , Uu          , Uu          , Ql          , Ql          , Ql          , Ql          , Ql          , Ql          , Ql          , Xu          , Xu          , Xu          , Xu          , Xu          , Xu          
Xu          , Xu          , Xu          , Xu          , Xu          , Xu          , Xu          , Xu          , Xu          , Ql          , Ql          , Uu          , Uu          , Uu^Vu       , Uu          , Ql          , Uu          , Uu^Vu       , Uu          , Uu          , Ql          , Ql          , Ql          , Ql          , Ql          , Ql          , Xu          , Ql          , Xu          , Xu          , Ql          , Xu          
Xu          , Xu          , Xu          , Xu          , Xu          , Xu          , Xu          , Xu          , Ql          , Ql          , Ql          , Ql          , Uu          , Uu          , Uu          , Uu          , Uh          , Uh          , Uh          , Uh          , Ql          , Ql          , Ql          , Ql          , Ql          , Ql          , Xu          , Xu          , Xu          , Xu          , Ql          , Xu          
Xu          , Xu          , Xu          , Xu          , Xu          , Xu          , Xu          , Xu          , Ql          , Ql          , Ql          , Ql          , Uu          , Uu          , Uu          , Uu          , Uu          , Uh          , Uh          , Ql          , Ql          , Ql          , Ql          , Ql          , Ql          , Xu          , Ql          , Xu          , Xu          , Xu          , Xu          , Xu          
Xu          , Xu          , Xu          , Xu          , Xu          , Xu          , Xu          , Xu          , Ql          , Ql          , Ql          , Ql          , Uu          , Uu          , Cud         , Cud         , Cud         , Uu          , Uu          , Uu          , Ql          , Ql          , Ql          , Ql          , Ql          , Ql          , Xu          , Xu          , Xu          , Xu          , Xu          , Xu          
Xu          , Xu          , Xu          , Xu          , Ql          , Ql          , Ql          , Xu          , Ql          , Ql          , Ql          , Uu          , Uu^Vu       , Uu          , Cud         , 1 Kud       , Cud         , Uu          , Uu          , Uu^Vu       , Ql          , Ql          , Ql          , Ql          , Ql          , Ql          , Ql          , Xu          , Xu          , Xu          , Xu          , Xu          
Xu          , Xu          , Xu          , Xu          , Ql          , Ql          , Ql          , Ql          , Ql          , Ql          , Uu          , Uu          , Uh          , Uu          , Uu          , Uu          , Uu          , Uu          , Uu^Vu       , Ql          , Ql          , Ql          , Ql          , Ql          , Ql          , Ql          , Ql          , Ql          , Xu          , Xu          , Ql          , Xu          
Xu          , Xu          , Ql          , Ql          , Ql          , Ql          , Ql          , Ql          , Ql          , Ql          , Uu          , Uh          , Uh          , Uh          , Uu          , Uu          , Uu          , Uu          , Uu          , Ql          , Ql          , Ql          , Ql          , Ql          , Ql          , Ql          , Ql          , Ql          , Ql          , Ql          , Ql          , Ql          
