border_size=1
usage=map

Mm          , Mm          , Mm          , Mm          , Mm          , Mm          , Mm          , Mm          , Mm          , Hh          , Hh          , Gg          , Gg          , Ww          , Ww          , Wo          , Wo          , Wo          , Wo          , Wo          , Ww          , Gg          , Gg          , Gg          , Gg          , Gg          , Gg          , Gg          , Gs^Fms      , Gs^Fms      , Gs^Fms      , Gg          , Gs^Fms      , Gs^Fms      , Gs^Fms      , Gs^Fms      , Gg          , Gg          , Gg          , Gg          , Gs^Fms      , Gs^Fms      
Mm          , Mm          , Mm          , Mm          , Hh          , Hh          , Hh^Fp       , Mm          , Mm          , Hh          , Gs^Fp       , Gg          , Gs^Fp       , Ww          , Ww          , Ww          , Ww          , Wo          , Wo          , Wo          , Wo          , Ww          , Gg          , Gg          , Gg          , Gg          , Gg          , Gg          , Gs^Fms      , Gs^Fms      , Gs^Fms      , Gs^Fms      , Gs^Fms      , Gs^Fms      , Gs^Fms      , Gs^Fms      , Gs^Fms      , Gs^Fms      , Gs^Fms      , Gg          , Gs^Fms      , Gs^Fms      
Mm          , Mm          , Mm          , Mm          , Hh          , Hh          , Mm          , Hh^Fp       , Hh^Fp       , Hh^Fp       , Hh^Fp       , Gs^Fp       , Gs^Fp       , Gs^Fp       , Gg          , Ww          , Ww          , Ww          , Ww          , Wo          , Wo          , Ww          , Gg          , Gg          , Gg          , Gg          , Gg          , Gg          , Gs^Fms      , Gs^Fms      , Gg^Fet      , Gs^Fms      , Gs^Fms      , Gs^Fms      , Gs^Fms      , Gs^Fms      , Cv          , Cv          , 2 Kv        , Gg          , Cv          , Gs^Fms      
Mm          , Mm          , Mm          , Mm          , Chr         , Hh          , Mm          , Mm          , Hh          , Mm          , Hh^Fp       , Gg          , Gg          , Gs^Fp       , Gg          , Gg          , Gg          , Ww          , Ww          , Wo          , Wo          , Ww          , Ww          , Ww          , Gg          , Gg          , Gg          , Gg          , Gs^Fms      , Gs^Fms      , Gs^Fms      , Gg^Ve       , Gs^Fms      , Gs^Fms      , Gs^Fms      , Gs^Fms      , Gs^Fms      , Gs^Fms      , Gs^Fms      , Cv          , Gs^Fms      , Gg          
Mm          , Mm          , Mm          , Mm          , Chr         , 1 Khr       , Chr         , Mm          , Hh          , Hh          , Mm^Vhh      , Hh          , Gg          , Gs^Fp       , Gg          , Gg          , Gg          , Gg          , Ww          , Wo          , Wo          , Wo          , Wo          , Ww          , Gg          , Gg          , Gg          , Gs^Fms      , Gs^Fms      , Gg          , Gs^Fms      , Gs^Fms      , Gs^Fms      , Gs^Fms      , Gs^Fms      , Gg^Fet      , Gs^Fms      , Gs^Fms      , Gg          , Gs^Fms      , Gs^Fms      , Gs^Fms      
Mm          , Mm          , Mm          , Mm          , Mm          , Chr         , Chr         , Mm          , Gg          , Hh^Fp       , Hh          , Gg          , Gg          , Gs^Fp       , Gg          , Gg          , Gg          , Gg          , Ww          , Wo          , Wo          , Wo          , Wo          , Ww          , Gg          , Gg          , Gg          , Gs^Fms      , Gs^Fms      , Gg          , Gs^Fms      , Gs^Fms      , Gs^Fms      , Gs^Fms      , Gs^Fms      , Gs^Fms      , Gg          , Gg          , Gg          , Gs^Fms      , Gs^Fms      , Gs^Fms      
Mm          , Mm          , Mm          , Mm          , Mm          , Mm          , Hh          , Gg          , Gg          , Hh          , Hh^Fp       , Gs^Fp       , Gs^Fp       , Gg          , Gg          , Gg          , Gg          , Wwf         , Ww          , Wo          , Wo          , Wo          , Ww          , Ww          , Ww          , Gg          , Gg          , Gs^Fms      , Gg          , Gs^Fms      , Gs^Fms      , Gg          , Gg          , Gs^Fms      , Gs^Fms      , Gg^Ve       , Gs^Fms      , Gs^Fms      , Gs^Fms      , Gs^Fms      , Gs^Fms      , Gs^Fms      
Mm          , Mm          , Mm          , Mm^Vhh      , Mm          , Mm          , Hh          , Hh          , Hh          , Hh^Fp       , Gs^Fp       , Gs^Fp       , Gs^Fp       , Gg          , Gg          , Gg          , Gg          , Ww          , Wo          , Wo          , Wo          , Wo          , Wo          , Ww          , Ww          , Gg          , Gg          , Gs^Fms      , Gg          , Gg          , Gg          , Gs^Fms      , Gg          , Gs^Fms      , Gs^Fms      , Gs^Fms      , Gs^Fms      , Gs^Fms      , Gs^Fms      , Gs^Fms      , Gs^Fms      , Gs^Fms      
Mm          , Mm          , Mm          , Mm          , Mm          , Mm          , Hh          , Hh^Fms      , Hh^Fp       , Hh          , Gg          , Gs^Fp       , Gg          , Gg          , Gg          , Gg          , Gg          , Ww          , Wo          , Wo          , Wo          , Wo          , Wo          , Ww          , Gg          , Gg          , Gg          , Gs^Fms      , Gg          , Gs^Fms      , Gg          , Gg          , Gg          , Gg          , Gg          , Gs^Fms      , Gg          , Gg          , Gs^Fms      , Gs^Fms      , Gg          , Gs^Fms      
Mm          , Mm          , Mm          , Mm          , Hh          , Hh          , Mm          , Hh          , Gg          , Hh          , Gg          , Gs^Fp       , Gg          , Gg          , Gg          , Gg          , Gg          , Ww          , Ww          , Wo          , Wo          , Wo          , Ww          , Ww          , Gg          , Gg          , Gg          , Gg          , Gg          , Gg          , Ww          , Ww          , Gg          , Gg          , Gg          , Gg          , Gg          , Gs^Fms      , Wwf         , Wwf         , Wwf         , Gg          
Mm          , Mm          , Mm          , Mm          , Mm          , Hh          , Gg          , Gg          , Gg          , Gg          , Gg          , Gg          , Gg          , Gg          , Gg          , Gg          , Gg          , Ww          , Ww          , Wo          , Wo          , Wo          , Ww          , Gg          , Ww          , Ww          , Gg          , Gg          , Ww          , Ww          , Gg          , Ww          , Ww          , Gg          , Gg          , Gg          , Ww          , Ww          , Gg          , Ww          , Ww          , Ww          
Mm          , Mm          , Mm          , Mm          , Mm          , Mm          , Mm          , Gg          , Hh          , Gg          , Gg          , Hh          , Gg          , Gg          , Gg          , Gg          , Gg          , Gg          , Ww          , Wo          , Wo          , Ww          , Ww          , Ww          , Gg          , Ww          , Ww          , Ww          , Ww          , Gg          , Gg          , Ww          , Ww          , Ww          , Ww          , Ww^Bw|      , Gg          , Gg          , Gg          , Gg          , Gg          , Ww          
Mm          , Mm          , Mm          , Mm          , Mm          , Mm          , Hh          , Mm          , Mm          , Mm          , Mm          , Hh          , Gg          , Gg          , Gg          , Gg          , Gg          , Gg          , Wwf         , Ww          , Wo          , Ww          , Wo          , Ww          , Gg          , Ww          , Ww          , Ww          , Ww          , Ww          , Ww          , Ww          , Gg          , Ww          , Gg          , Gg          , Gg          , Gg          , Gg          , Gg          , Gs^Fds      , Gg          
Mm          , Mm          , Mm          , Mm          , Hh          , Mm          , Mm          , Mm          , Mm          , Mm^Vhh      , Mm          , Hh          , Hh          , Gg          , Gg          , Gg          , Gg          , Gg          , Gg          , Ww          , Wo          , Wo          , Ww          , Ww          , Ww          , Ww          , Ww          , Ww          , Gg          , Gg          , Gg          , Gg          , Gg          , Gg          , Gg          , Gg          , Gg          , Gg          , Gg          , Gs^Fds      , Gs^Fds      , Gg          
Mm          , Mm          , Mm          , Mm          , Mm          , Mm^Vhh      , Mm          , Mm          , Hh^Fms      , Mm          , Hh          , Hh          , Gg          , Gg          , Gg          , Gg          , Gg          , Gg          , Wwf         , Ww          , Wo          , Wo          , Ww          , Ww          , Gg          , Gg          , Ww          , Ww          , Gg          , Gg          , Gg          , Gg          , Gg          , Gg          , Gg          , Gg          , Gg          , Gg          , Gg          , Gs^Fds      , Gs^Fms      , Gg          
Mm          , Mm          , Hh          , Mm          , Hh          , Mm          , Hh^Fms      , Hh^Fms      , Hh^Fms      , Hh^Fms      , Hh          , Hh          , Gg          , Gg          , Gg          , Gg          , Gg          , Gg          , Ww          , Ww          , Wo          , Wo          , Ww          , Ww          , Gg          , Gg          , Ww          , Ww          , Gg          , Gg          , Gg          , Gs^Fms      , Gs^Fms      , Gg          , Gg          , Gg          , Gs^Fms      , Gs^Fms      , Gg          , Gs^Fms      , Gs^Fms      , Gg          
Mm          , Mm          , Hh          , Hh          , Hh          , Hh          , Hh          , Hh^Fms      , Hh^Fms      , Hh^Fms      , Gg          , Gg          , Gg          , Gg          , Gg          , Gg          , Gg          , Gg          , Ww          , Ww          , Wo          , Wo          , Ww          , Gg          , Ww          , Ww          , Gg          , Gg          , Gg          , Gg          , Gg          , Gg          , Gg          , Gg          , Gs^Fms      , Gs^Fms      , Gs^Fds      , Gs^Fds      , Gg          , Gs^Fms      , Gs^Fms      , Gg          
Mm          , Mm          , Mm          , Hh          , Gg          , Gg          , Hh          , Hh^Fms      , Gs^Fms      , Gs^Fms      , Gs^Fms      , Gg          , Gg          , Gg          , Gg          , Gg          , Gg          , Gg          , Ww          , Ww          , Wo          , Wo          , Ww          , Ww^Yes         , Gg          , Gg          , Gg          , Gg          , Gg          , Gg          , Gg          , Gg          , Gg          , Gs^Fms      , Gs^Fds      , Gg^Ve       , Gs^Fms      , Gs^Fds      , Gg          , Gs^Fms      , Gs^Fms      , Gg          
Mm          , Mm          , Mm          , Hh          , Hh          , Gg          , Hh          , Hh          , Gs^Fms      , Gs^Fp       , Gg          , Gg          , Gg          , Gg          , Gg          , Gg          , Gg          , Gg          , Ww          , Wo          , Wo          , Wo          , Ww          , Ww^Bw\      , Cv          , Rp          , Gg^Ve       , Gg          , Gg          , Gg          , Gs^Fms      , Gg          , Gg          , Gs^Fds      , Gs^Fds      , Gs^Fms      , Gg          , Gg          , Gs^Fms      , Gs^Fms      , Gs^Fms      , Gs^Fms      
Ww          , Mm          , Mm          , Hh          , Hh          , Gg          , Hh          , Hh^Vhh      , Gg          , Gg          , Gg          , Gg          , Gg          , Gg          , Gg          , Gg          , Gg          , Gg          , Chw         , Wo          , Wo          , Ww          , Ww          , Ww          , Rp          , Rp          , Rp          , Gg          , Gg          , Gg          , Gg          , Gg          , Gs^Fms      , Gg          , Gg          , Gg          , Gs^Fds      , Gg          , Gs^Fds      , Gs^Fds      , Gg^Ve       , Gs^Fms      
Mm          , Ww          , Ww          , Mm          , Hh          , Gg          , Ww          , Hh          , Ww          , Gg          , Gg          , Gg          , Gg          , Gg          , Gg          , Gg          , Gg          , Gg          , Ww          , Wo          , Wo          , Ww          , Ww          , Ww          , Cv          , Rp          , Gg^Ve       , Gg          , Gg          , Gg          , Gg          , Gs^Fms      , Gs^Fms      , Gs^Fms      , Gg          , Gs^Fms      , Gs^Fms      , Gs^Fms      , Gs^Fds      , Gs^Fds      , Gs^Fms      , Gs^Fms      
Mm          , Mm          , Mm          , Wwf         , Wwf         , Wwf         , Hh          , Ww          , Wwf         , Gg          , Gg          , Gg          , Gg          , Gg          , Gg          , Gg          , Gg          , Wwf         , Ww          , Wo          , Wo          , Wo          , Ww          , Ww^Bw/      , Gg          , Rp          , Gg          , Gg          , Gs^Fms      , Gs^Fms      , Gs^Fms      , Gs^Fms      , Gs^Fds      , Gs^Fds      , Gs^Fds      , Gs^Fms      , Gs^Fms      , Gs^Fms      , Gs^Fds      , Gs^Fms      , Gs^Fms      , Gg          
Mm          , Mm          , Mm          , Gg          , Hh          , Hh          , Hh^Vhh      , Gg          , Gg          , Wwf         , Gg          , Gg          , Gg          , Gg          , Gg          , Gg          , Wwf         , Wwf         , Wo          , Wo          , Wo          , Wo          , Ww          , Ww^Yes         , Gg          , Gg          , Gg          , Gs^Fms      , Gs^Fms      , Gs^Fms      , Gs^Fms      , Gs^Fds      , Gs^Fds      , Gs^Fds      , Gg^Ve       , Gs^Fms      , Gs^Fms      , Gs^Fms      , Cv          , Gs^Fms      , Cv          , Gg          
Mm          , Mm          , Mm          , Mm          , Hh          , Hh          , Gg          , Gg          , Gg          , Wwf         , Wwf         , Wwf         , Wwf         , Ww          , Ww          , Wwf         , Ww          , Ww          , Ww          , Wo          , Wo          , Wo          , Ww          , Ww          , Gg          , Gg          , Gs^Fms      , Gs^Fms      , Gs^Fms      , Gs^Fms      , Gs^Fms      , Gs^Fms      , Gs^Fms      , Gs^Fms      , Gs^Fms      , Gs^Fds      , Gs^Fms      , Gg          , Cv          , 3 Kv        , Cv          , Gs^Fms      
Mm          , Mm          , Mm          , Mm          , Hh          , Gg          , Gg          , Gg          , Gg          , Gg          , Gg          , Wwf         , Gg          , Ww          , Gg          , Ww          , Ww          , Ww          , Ww          , Ww          , Wo          , Wo          , Ww          , Ww          , Ww          , Gg          , Gs^Fms      , Gs^Fms      , Gs^Fms      , Gs^Fms      , Gg          , Gg          , Gs^Fms      , Gs^Fms      , Gs^Fms      , Gs^Fds      , Gs^Fds      , Gs^Fms      , Gs^Fds      , Gs^Fms      , Gs^Fms      , Gs^Fms      
Mm          , Mm          , Mm          , Mm          , Hh          , Gg          , Gg          , Gg          , Gg          , Gg          , Gg          , Gg          , Gg          , Gg          , Gg          , Gg          , Ss          , Ww          , Ww          , Ww          , Ww          , Wo          , Wo          , Ww          , Ww          , Gg          , Gs^Fms      , Gs^Fms      , Gs^Fms      , Gg          , Gg          , Gg          , Gs^Fms      , Gg          , Gs^Fms      , Gs^Fms      , Gs^Fds      , Gs^Fds      , Gs^Fds      , Gs^Fms      , Gs^Fms      , Gs^Fms      
Mm          , Mm          , Mm          , Mm          , Hh          , Gg          , Gg          , Gg          , Gg          , Gg          , Gg          , Gg          , Gg          , Gg          , Gg          , Gg          , Ss          , Ss          , Ss^Vm       , Ww          , Ww          , Wo          , Wo          , Ww          , Ww          , Gg          , Gs^Fms      , Gs^Fms      , Gs^Fms      , Gs^Fms      , Gs^Fms      , Gs^Fms      , Gs^Fms      , Gs^Fms      , Gg          , Gs^Fms      , Gs^Fds      , Gs^Fds      , Gs^Fds      , Gs^Fms      , Gs^Fms      , Gs^Fms      
Mm          , Mm          , Mm          , Mm          , Hh          , Gg          , Hh          , Gg          , Gg          , Gg          , Gg          , Gg          , Gg          , Gg          , Ss          , Ss          , Ss          , Ss          , Ss          , Ww          , Ww          , Ww          , Wo          , Ww          , Ww          , Gg          , Gg          , Gs^Fms      , Gs^Fms      , Gs^Fms      , Gs^Fms      , Gs^Fms      , Gg          , Gg          , Gg          , Gg          , Gs^Fms      , Gs^Fms      , Gs^Fms      , Gs^Fds      , Gs^Fms      , Gs^Fms      
Mm          , Mm          , Mm          , Mm          , Hh^Fms      , Hh          , Mm          , Hh^Vhh      , Gg          , Gg          , Gg          , Gg          , Gg          , Gg          , Gg          , Ss          , Gg          , Ss          , Gg          , Ww          , Ww          , Ww          , Wo          , Wo          , Ww          , Gg          , Gg          , Gg          , Gg          , Gs^Fms      , Gs^Fms      , Gg          , Gg          , Gg          , Gg          , Gg          , Gs^Fms      , Gs^Fms      , Gg^Ve       , Gs^Fds      , Gs^Fms      , Gs^Fms      
Mm          , Mm          , Mm          , Hh          , Hh^Fms      , Mm          , Mm          , Hh          , Gg          , Gg          , Gs^Fms      , Gg          , Gg          , Gg          , Gg          , Gg          , Gg          , Gg          , Wwf         , Ww          , Ww          , Wo          , Wo          , Wo          , Ww          , Ww          , Gg          , Gg          , Gg          , Gg          , Gg          , Gg          , Gg          , Gg          , Gg          , Gs^Fms      , Gs^Fms      , Gs^Fms      , Gs^Fms      , Gs^Fms      , Gs^Fms      , Gs^Fms      
Mm          , Mm          , Hh          , Hh^Fms      , Mm^Vhh      , Mm          , Mm          , Hh          , Gs^Fms      , Gs^Fms      , Gs^Fms      , Gg          , Gg          , Gg          , Gg          , Gg          , Gg          , Gg          , Chw         , Ww          , Ww          , Wo          , Wo          , Wo          , Ww          , Ww          , Gs^Vht      , Gg          , Gg          , Gg          , Gg          , Gg          , Gg          , Gg          , Gg          , Gg          , Gg          , Gs^Fms      , Gs^Fms      , Gs^Fms      , Gs^Fms      , Gs^Fms      
Mm          , Mm          , Hh          , Hh          , Mm          , Mm          , Gg          , Hh          , Gs^Fms      , Gs^Fms      , Gs^Fms      , Gg          , Gg          , Gg          , Gg          , Gg          , Gg          , Chw         , Chw         , Ww^Bw\      , Ww          , Wo          , Wo          , Wo          , Ww          , Ww          , Gg          , Gg          , Gg          , Gg          , Gg          , Gg          , Gg          , Gg          , Gg          , Gg          , Gg          , Gg          , Gg          , Gs^Fms      , Gs^Fms      , Gs^Fms      
Mm          , Mm          , Mm          , Hh          , Hh          , Hh          , Hh          , Gs^Fms      , Gs^Fms      , Gs^Fms      , Gg          , Gg          , Gg          , Gg          , Gg          , Gg          , Gg          , Gg          , Gg          , Ww          , Ww          , Wo          , Wo          , Wo          , Ww          , Ww          , Wwf         , Gg          , Gg          , Gg          , Gg          , Gg          , Gg          , Gg          , Gg          , Gg          , Gg          , Gg          , Gg          , Gs^Fms      , Gs^Fms      , Gs^Fms      
Mm          , Mm          , Mm          , Mm          , Chr         , Mm          , Hh          , Gs^Fms      , Gs^Fms      , Gs^Fms      , Gg          , Gg          , Gg          , Gg          , Gg          , Gg          , Gg          , Gg          , Gg          , Ww          , Ww          , Wo          , Wo          , Ww          , Ww          , Ww          , Gg          , Ss^Vm       , Ss          , Gg          , Ss          , Gg          , Ss          , Gg          , Gg          , Gg          , Gg          , Gg          , Gg          , Gs^Fms      , Gs^Fms      , Gs^Fms      
Mm          , Mm          , Mm          , Chr         , Chr         , Hh          , Hh          , Hh          , Gg          , Gg          , Gg          , Gg          , Gg          , Gg          , Gg          , Gg          , Gg          , Gg          , Ss          , Ww          , Ww          , Wo          , Wo          , Ww          , Ww          , Ww          , Ss          , Ss          , Ww          , Ss          , Ww          , Ss          , Ww          , Ss          , Gg          , Gs^Vht      , Gg          , Gg          , Gg          , Gg          , Gg          , Gs^Fms      
Mm          , Mm          , Mm          , Mm          , Chr         , Chr         , Gg          , Gg          , Gg          , Gg          , Gg          , Gg          , Gg          , Gg          , Gg          , Gg          , Gg          , Gg          , Ss          , Ww          , Ww          , Ww          , Ww          , Wo          , Ww          , Ww          , Ss          , Ss          , Ss          , Ss          , Ss          , Ss          , Co          , Ww          , Co          , Gg          , Gg          , Gg          , Gg          , Gg          , Gg          , Gs^Fms      
Mm          , Mm          , Mm          , Mm          , 5 Khr       , Chr         , Mm          , Mm          , Mm          , Gg          , Gg          , Gg          , Gg          , Gg          , Gg          , Gg          , Gg          , Ss          , Ww          , Ww          , Ww          , Ww          , Ww          , Wo          , Wo          , Ww          , Ww          , Gg          , Gg          , Gg          , Ss          , Ss          , Co          , 4 Ko        , Co          , Gg          , Gg          , Gg          , Gg          , Gg          , Gg          , Gg          
Mm          , Mm          , Mm          , Mm          , Hh          , Chr         , Hh          , Mm^Vhh      , Mm          , Hh^Fms      , Gg          , Gg          , Gg          , Gg          , Gg          , Gg          , Gg          , Ss          , Ww          , Ww          , Ww          , Ww          , Ww          , Ww          , Wo          , Wo          , Wo          , Ww          , Ww          , Ss          , Ww          , Ss          , Ww          , Ww          , Ww          , Gg          , Gg          , Wwf         , Ss          , Ss          , Ss          , Gg          
Mm          , Mm          , Mm          , Mm          , Mm          , Hh^Fms      , Hh^Fms      , Hh^Fms      , Hh^Fms      , Hh^Fms      , Gs^Fms      , Gg          , Gg          , Gg          , Gg          , Gg          , Gg          , Ss          , Ss^Vm       , Ww          , Ss          , Ww          , Ww          , Ww          , Ww          , Wo          , Wo          , Ww          , Ww          , Ss          , Ss          , Ss          , Ss          , Ss          , Ss          , Wwf         , Wwf         , Wwf         , Gg          , Ss          , Ww          , Ss          
Mm          , Mm          , Mm          , Mm          , Mm          , Mm          , Mm          , Hh^Fms      , Hh^Fms      , Hh^Fms      , Gs^Fms      , Gs^Fms      , Gs^Fms      , Gg          , Gg          , Gg          , Ss          , Ss          , Ss          , Ww          , Ss          , Ww          , Ss          , Ww          , Ww          , Wo          , Wo          , Wo          , Wo          , Ww          , Ww          , Ss          , Ss          , Ss          , Gg          , Ss          , Gg          , Gg          , Gg          , Gg          , Gg          , Gg          
Mm          , Mm          , Mm          , Mm          , Mm          , Mm          , Mm          , Hh          , Hh          , Gs^Fms      , Gs^Fms      , Gg          , Gs^Fms      , Gg          , Ss          , Ss          , Ss          , Ss          , Ss          , Ww          , Ss          , Ss          , Ss          , Ww          , Ww          , Ww          , Ww          , Ww          , Ww          , Wo          , Ww          , Ww          , Ss          , Ss          , Gg          , Gg          , Gg          , Gs^Vht      , Gg          , Gg          , Gg          , Gg          
Mm          , Mm          , Mm          , Mm          , Hh          , Hh          , Hh          , Hh          , Hh          , Gs^Fms      , Hh          , Gs^Fms      , Gg          , Ss          , Ss          , Ss          , Ss          , Ss          , Ss          , Ss          , Ss          , Ss          , Ss          , Ww          , Ww          , Ww          , Ww          , Ww          , Ww          , Wo          , Wo          , Ww          , Ss          , Ss          , Ss          , Gg          , Gg          , Gg          , Gg          , Gg          , Gg          , Gg          
