|00000000000000000000000000000000000000000000000
|00000000000000000000000000000000000000000000000
|00000000000000000000000000000000000000000000000
|00000000000000000000000000000000000000000000000
|00000000000000000000000000000000000000000000000
|00000000000000000000000000000000000000000000000
|00000000001111111111111000011110000000000000000
|00000000001111111111111100011111000000000000000
|00000000011111111111111110011110011000000000000
|00000000011111111111111111001111011100000000000
|00000000111111111111111111011110111100000000000
|00000000111111111111111111001111111110000000000
|00000001111111111111111111001111111100000000000
|00000001111111111111111111101111111110000000000
|00000011111111111111111111101111111100000000000
|00000011111111111111111111101111111100000000000
|00000011111111111111111111111111111000000000000
|00000011111111111111111111111111111100000111100
|00000011111111111111111111111111111000001111100
|00000011111111111111111111111111111110001111110
|00000011111111111111111111111111111110001111100
|00000011111111111111111111111111111111111111110
|00000011111111111111111111111111111111111111110
|00000011111111111111111111111111111111111111111
|00000011111111111111111111111111111111111111111
|00000011111111111111111111111111111111111111111
|00000011111111111111111111111111111111111111111
|00000001111111111111111111111111111111011111111
|00000001111111110000011111111111111111011111111
|00000000111111110000000111111111111111001111000
|00000000000000000000000111111100000000000000000
|00000000000000000000000001111000000000000000000
|00000000000000000000000000000000000000000000000
|00000000000000000000000000000000000000000000000
|00000000000000000000000000000000000000000000000
|00000000000000000000000000000000000000000000000
|00000000000000000000000000000000000000000000000
