border_size=1
usage=map

Chs         , Chs         , Chs         , Chs         , Chs         , Ss          , Ss          , Ss          , Ss          , Ss          , Ww          , Ww          , Ss          , Ss          , Ww          , Ww          , Ww          , Gg          , Gs^Fds      , Gs^Fds      , Gs^Fds      , Gs^Fds      , Gs^Fds      , Ww          , Gs^Fds      , Gs^Fds      , Gs^Fds      , Gs^Fds      , Gs^Fds      , Gs^Fds      , Gs^Fds      , Gs^Fds      , Gs^Fds      , Gs^Fds      , Gs^Fds      , Gs^Fds      , Hh^Fds      , Hh^Fds      , Hh^Fds      , Mm          , Mm          , Mm          , Mm          , Mm          , Mm          , Gg          , Gg          , Rd          , Gg          , Gg          , Gg          , Gg          , Ww          , Ww          , Wo          , Wo          , Wo          
Chs         , Chs         , 2 Khs       , Chs         , Ww          , Ww          , Ww          , Ss          , Ww          , Ww          , Ww          , Ss          , Ss          , Ss          , Ww          , Ww          , Ww          , Gg          , Gs^Fds      , Gs^Fds      , Rd          , Gg^Ve       , Ww          , Ww          , Gs^Fds      , Gg^Ve       , Gs^Fds      , Cv          , Gs^Fds      , Gs^Fds      , Gs^Fds      , Gs^Fds      , Gs^Fds      , Gs^Fds      , Gs^Fds      , Hh^Fds      , Hh^Fds      , Hh^Fds      , Mm          , Hh^Fds      , Mm          , Mm          , Mm          , Mm          , Mm          , Gg          , Gg^Vh       , Rd          , Rd          , Gg          , Gg          , Gg          , Gg          , Ww          , Ww          , Wo          , Wo          
Chs         , Chs         , Chs         , Chs         , Ww          , Ss^Vhs      , Ss          , Ww          , Ss          , Ww          , Ww          , Ss^Vhs      , Ww          , Ww          , Ww          , Gg          , Gg          , Ww          , Ww          , Gs^Fds      , Ww          , Wwf         , Rd          , Gs^Fds      , Rd          , Rd          , Gs^Fds      , Cv          , 4 Kv        , Gs^Fds      , Cv          , Gs^Fds      , Gg          , Gs^Fds      , Gs^Fds      , Hh^Fds      , Gs^Fds      , Gg          , Hh^Fds      , Mm          , Mm          , Mm          , Gs^Fds      , Mm          , Gg          , Gs^Fds      , Re^Gvs      , Re^Gvs      , Gg^Vh       , Rd          , Rd          , Gg          , Gg          , Gg          , Ww          , Wo          , Wo          
Chs         , Chs         , Ss          , Ww          , Ww          , Ss          , Ss          , Ss          , Ss          , Ww          , Gg          , Ww          , Gg          , Ww          , Gg          , Gg          , Gg          , Gs^Fds      , Gs^Fds      , Ww          , Gs^Fds      , Gs^Fds      , Gs^Fds      , Rd          , Gs^Fds      , Gs^Fds      , Gs^Fds      , Cv          , Cv          , Cv          , Gs^Fds      , Gs^Fds      , Gg          , Gs^Fds      , Gs^Fds      , Gs^Fds      , Hh^Fds      , Hh^Fds      , Hh^Fds      , Mm          , Hh^Fds      , Mm          , Gg          , Gs^Fds      , Gs^Fds      , Gs^Fds      , Gg^Vh       , Re^Gvs      , Gs^Fds      , Gs^Fds      , Rd          , Gg          , Gg          , Gg          , Ww          , Wo          , Wo          
Ww          , Ww          , Ww          , Ww          , Ss          , Ss          , Ss          , Ss          , Ww          , Ww          , Gg          , Ww          , Gg          , Gg          , Gg          , Gg          , Gs^Fds      , Gs^Fds      , Gg          , Gs^Fds      , Gs^Fds      , Gs^Fds      , Gs^Fds      , Gs^Fds      , Gs^Fds      , Gs^Fds      , Gs^Fds      , Cv          , Gs^Fds      , Gs^Fds      , Gs^Fds      , Gs^Fds      , Gs^Fds      , Gs^Fds      , Gg          , Gs^Fds      , Hh^Fds      , Hh^Fds      , Hh^Fds      , Hh^Fds      , Gs^Fds      , Gg          , Gs^Fds      , Gs^Fds      , Gs^Fds      , Gs^Fds      , Gs^Fds      , Gg          , Gs^Fds      , Gg          , Rd          , Gg          , Gg          , Gg          , Ww          , Wo          , Wo          
Ww          , Ss^Vhs      , Ww          , Ss          , Ss          , Ss          , Gg          , Ww          , Ss          , Ss          , Gg          , Ww          , Ww          , Gg          , Gg          , Gs^Fds      , Gs^Fds      , Gs^Fds      , Gg          , Gg          , Gs^Fds      , Gs^Fds      , Gs^Fds      , Gs^Fds      , Gs^Fds      , Gs^Fds      , Gs^Fds      , Rd          , Gs^Fds      , Gs^Fds      , Gs^Fds      , Gs^Fds      , Gs^Fds      , Gs^Fds      , Gs^Fds      , Hh^Fds      , Hh^Fds      , Hh^Fds      , Hh^Fds      , Gs^Fds      , Gs^Fds      , Gs^Fds      , Gs^Fds      , Gs^Fds      , Gs^Fds      , Gs^Fds      , Gg          , Gg          , Gg          , Gg          , Rd          , Gg          , Gg          , Ww          , Ww          , Wo          , Wo          
Ss          , Ss          , Ww          , Ss          , Ss          , Gg          , Ss^Vhs      , Ss          , Gg          , Gg          , Gg          , Gg          , Ww          , Gg          , Gg          , Gg          , Gg          , Gg          , Gs^Fds      , Gs^Fds      , Gs^Fds      , Gs^Fds      , Gg          , Gs^Fds      , Gs^Fds      , Gs^Fds      , Gg^Fet      , Rd          , Gs^Fds      , Gs^Fds      , Gs^Fds      , Gs^Fds      , Gs^Fds      , Gs^Fds      , Gg          , Hh^Fds      , Gg          , Hh^Fds      , Gg          , Gs^Fds      , Gg          , Gg          , Gs^Fds      , Gs^Fds      , Gg          , Gg          , Gg          , Gg          , Gg          , Gg          , Rd          , Gg          , Gg          , Ww          , Wo          , Wo          , Wo          
Ss          , Ss          , Ww          , Gg          , Ss          , Ss          , Ss          , Ss          , Re^Gvs      , Re^Gvs      , Gg          , Gg          , Ww          , Gg          , Gg          , Gg          , Gg          , Gs^Fds      , Gs^Fds      , Gs^Fds      , Gs^Fds      , Gg          , Gg          , Gs^Fds      , Gs^Fds      , Gs^Fds      , Gs^Fds      , Rd          , Gg^Ve       , Gg^Fet      , Gs^Fds      , Gs^Fds      , Gg          , Gs^Fds      , Gg          , Gg          , Gg          , Gg          , Gg          , Gs^Fds      , Gg          , Gg          , Gg          , Gg          , Gg          , Gg          , Gg          , Gg          , Gg          , Gg          , Rd          , Gg          , Wwf         , Ww          , Wo          , Wo          , Wo          
Ss          , Ss          , Ww          , Gg          , Ss          , Gg          , Gg          , Re^Gvs      , Re^Gvs      , Re^Gvs      , Gg          , Ww          , Gg          , Gg          , Gg          , Gg          , Gg          , Gg          , Gg          , Gs^Fds      , Gg          , Gg          , Gg          , Gs^Fds      , Gs^Fds      , Gs^Fds      , Gs^Fds      , Gs^Fds      , Rd          , Gs^Fds      , Gs^Fds      , Gs^Fds      , Gs^Fms      , Gg          , Gg          , Gg          , Gg          , Gg          , Gg          , Gg          , Gg          , Gs^Fds      , Gg          , Gg          , Gg          , Gg          , Gg          , Gg          , Gg          , Gg          , Rd          , Gg          , Wwf         , Ww          , Wo          , Wo          , Wo          
Ss          , Gg          , Ss          , Ww          , Gg          , Gg          , Gg          , Re^Gvs      , Re^Gvs      , Re^Gvs      , Gg          , Ww          , Gg          , Gg          , Gg          , Ql          , Ql          , Ql          , Gg          , Gg          , Gg          , Gg          , Gg          , Gs^Fds      , Gs^Fds      , Gs^Fds      , Gs^Fds      , Gs^Fds      , Rd          , Gs^Fds      , Gs^Fds      , Gs^Fds      , Gs^Fms      , Gg          , Gg          , Gg          , Gg          , Gg          , Gg          , Gg          , Gs^Fds      , Gs^Fds      , Gg          , Gg          , Gg          , Gg          , Gg          , Gg          , Gg          , Gg^Vc       , Rd          , Wwf         , Wwf         , Wo          , Wo          , Wo          , Wo          
Gg          , Ss          , Gg          , Ww          , Ww          , Gg          , Gg          , Re^Gvs      , Re^Gvs      , Re^Gvs      , Ww          , Ww          , Gg          , Gg          , Gg          , Ql          , Ql          , Ql          , Ql          , Ql          , Gg          , Gg          , Gg          , Gg          , Gg          , Gs^Fds      , Gs^Fds      , Gs^Fds      , Rd          , Gg^Fet      , Gg^Ve       , Gs^Fds      , Gg          , Gg          , Gs^Fds      , Gs^Fds      , Gg          , Gg          , Gg          , Gs^Fds      , Gs^Fds      , Gs^Fds      , Gs^Fds      , Gg          , Gg          , Gg          , Gg          , Gg          , Gg          , Gg          , Co          , Co          , Ww^Bw/      , Ww          , Wo          , Wo          , Wo          
Gg          , Gg          , Gg          , Ww          , Ww          , Gg          , Gg          , Gg^Vh       , Gg          , Gg          , Ww          , Gg          , Gg          , Gg          , Ql          , Ql          , Ql          , Ql          , Ql          , Ql          , Gg          , Gg          , Gg          , Gg          , Gg          , Gs^Fds      , Gs^Fds      , Gs^Fds      , Rd          , Rd          , Gs^Fds      , Gs^Fds      , Gs^Fds      , Gs^Fds      , Gg          , Gg          , Gg          , Gg          , Gs^Fds      , Gs^Fds      , Gs^Fds      , Gg          , Gs^Fds      , Gs^Fds      , Gg          , Gg          , Gg          , Gg          , Gg          , Gg          , Co          , 1 Ko        , Ww          , Ww          , Wo          , Wo          , Wo          
Gg          , Gg          , Gg          , Ww          , Gg          , Gg          , Gg          , Gg          , Ww          , Ww^Bw\      , Gg          , Gg          , Mm          , Gg          , Uu^Dr       , Ql          , Ql          , Uu          , Mm          , Gg          , Gg          , Gg          , Gg          , Gg          , Gg          , Gg          , Rd          , Rd          , Gs^Fds      , Gs^Fds      , Gs^Fds      , Gs^Fds      , Gs^Fms      , Gs^Fds      , Gg          , Gg          , Gg          , Gs^Fds      , Gg          , Gs^Fds      , Gg          , Gs^Fds      , Gg          , Gs^Fds      , Gg          , Gg          , Re          , Re          , Re          , Gg          , Rd          , Co          , Wwf         , Gg^Vc       , Wo          , Wo          , Wo          
Gg          , Gg          , Gg          , Ww          , Ww          , Gg          , Gg          , Gg          , Ww          , Gg          , Gg          , Gg          , Mm          , Hh^Dr       , Uu^Dr       , Ql          , Ql          , Uu          , Mm          , Gg          , Gg          , Gg          , Gg          , Gg          , Gg          , Gg          , Gs^Fds      , Gs^Fds      , Gs^Fds      , Gs^Fds      , Gs^Fds      , Gs^Fds      , Gs^Fds      , Gs^Fds      , Gg          , Gg          , Gg          , Gg          , Gg          , Gs^Fds      , Gg          , Gg          , Gg          , Gg          , Gg          , Re          , Re          , Re          , Re          , Gg^Vc       , Rd          , Gg          , Wwf         , Wwf         , Wo          , Wo          , Wo          
Gg          , Gg          , Gg          , Ww          , Ww          , Gg          , Ww          , Ww          , Gg          , Gg          , Gg          , Mm          , Hh^Dr       , Uu^Dr       , Uu^Dr       , Ql          , Uu^Dr       , Uu^Dr       , Uu^Dr       , Mm          , Gg          , Gg          , Gg          , Gg          , Gg          , Gg          , Gs^Fds      , Gs^Fds      , Gg          , Gs^Fds      , Gs^Fds      , Gs^Fds      , Gs^Fds      , Gs^Fds      , Gs^Fds      , Gs^Fds      , Gg^Ve       , Gg          , Gg          , Gs^Fds      , Gg          , Gg          , Re          , Gg          , Re          , Re          , Re          , Re          , Re          , Re          , Rd          , Re          , Re          , Wwf         , Wo          , Wo          , Wo          
Gg          , Gg          , Gg          , Ww          , Gg          , Ww          , Ww          , Gg          , Gg          , Gg          , Gg          , Gg          , Mm          , Uu^Dr       , Uh          , Uh          , Uh          , Uu^Dr       , Hh^Dr       , Gg          , Gg          , Gg          , Gg          , Gg          , Gg          , Gg          , Gg          , Gg          , Gg          , Gs^Fds      , Gs^Fds      , Gs^Fds      , Gg          , Gg          , Gg          , Gg          , Gg          , Gg          , Gg          , Gg          , Gg          , Gg          , Gg          , Re          , Re          , Re          , Re          , Re          , Re          , Re          , Rd          , Re          , Re          , Ww          , Wo          , Wo          , Wo          
Gg          , Gg          , Ww          , Ww          , Gg          , Ww          , Ww          , Gg          , Gg          , Gg          , Gg          , Mm          , Mm          , Uu^Dr       , Uu^Dr       , Uh          , Uu^Dr       , Uu^Dr       , Hh^Dr       , Mm          , Gg          , Gg          , Gg          , Gg          , Gg          , Gg          , Gg          , Gg          , Gg          , Gg          , Gg          , Gs^Fds      , Gg          , Gg          , Gg          , Gg          , Gg          , Gg          , Gg          , Gg          , Gg          , Gg          , Re          , Re          , Re          , Re          , Re          , Re          , Re          , Re          , Rd          , Re          , Ww          , Ww          , Wo          , Wo          , Wo          
Gg          , Ww          , Ww          , Gg          , Gg          , Gg          , Gg          , Ww          , Ww          , Gg          , Gg          , Gg          , Mm          , Hh^Dr       , Chr         , Uu^Dr       , Chr         , Chr         , Mm          , Gg          , Gg          , Gg          , Gg          , Gg          , Gg          , Gg          , Gs^Fds      , Gg          , Gg          , Gg          , Gg          , Gg          , Hh          , Hh          , Gg          , Gg          , Gg          , Gg          , Gg          , Gg          , Gg          , Re          , Gg          , Re          , Gg          , Re          , Gg          , Re          , Rd          , Rd          , Re          , Re          , Ww          , Wo          , Wo          , Wo          , Wo          
Ww          , Ww          , Ww          , Gg          , Ww          , Ww          , Ww          , Ww          , Gg          , Gg          , Gg          , Gg          , Gg          , Rd          , Mm          , Chr         , Mm          , Gg          , Gg          , Gg          , Gg          , Gg          , Gg          , Gg          , Gg          , Gs^Fds      , Hh^Fms      , Gs^Fds      , Gs^Fds      , Gg          , Hh          , Hh          , Hh          , Hh          , Hh          , Gg          , Gg          , Gg          , Gg          , Gg          , Gg          , Re          , Gg          , Gg          , Gg          , Gg          , Rd          , Rd          , Gg          , Re          , Re          , Re          , Ww          , Ww          , Wo          , Wo          , Wo          
Gg          , Gg          , Ww          , Ww          , Gg          , Ww          , Gg          , Gg          , Gg          , Gg          , Gg          , Gg          , Rd          , Rd          , Gg          , Gg          , Gg          , Gg          , Gg          , Gg          , Gg          , Gg          , Gg          , Gg          , Hh^Fms      , Gs^Fds      , Hh^Fms      , Hh^Fms      , Hh^Fms      , Hh^Fms      , Hh          , Hh          , Hh          , Hh          , Hh          , Hh          , Gg          , Gg          , Gg          , Gg          , Gg          , Gg          , Gg          , Gg          , Rd          , Rd          , Gg          , Gg          , Gg          , Gg          , Re          , Re          , Ww          , Ww          , Wo          , Wo          , Wo          
Gg          , Gg          , Ww          , Gg          , Gg          , Gg          , Gg          , Gg          , Gg          , Gg          , Rd          , Rd          , Re^Gvs      , Gg          , Gg          , Gg          , Gg          , Gg          , Gg          , Gs^Fds      , Gs^Fds      , Gg          , Gg          , Gg          , Hh^Fms      , Hh^Fms      , Hh^Fms      , Hh^Fms      , Hh          , Hh          , Hh          , Mm          , Mm          , Mm          , Mm          , Hh          , Hh^Fds      , Gg          , Hh          , Gg          , Gg          , Gg          , Gg          , Rd          , Gg          , Gg          , Gg          , Gg          , Gg          , Gg          , Gg          , Ww          , Ww          , Wo          , Wo          , Wo          , Wo          
Gg          , Gg          , Ww          , Ww          , Gg          , Gg          , Gg          , Gg          , Rd          , Rd          , Re^Gvs      , Re^Gvs      , Re^Gvs      , Gg          , Gg          , Gg          , Gg          , Gg          , Gg          , Gs^Fds      , Hh^Fms      , Gs^Fds      , Gs^Fds      , Gg          , Hh          , Hh^Fms      , Mm          , Mm          , Mm          , Hh          , Mm          , Mm          , Mm          , Mm          , Mm          , Hh          , Hh          , Hh          , Hh          , Hh^Fds      , Gg          , Gg          , Gg          , Rd          , Gg          , Gg          , Gg          , Gg          , Gg          , Gg          , Ww          , Ww          , Wo          , Wo          , Wo          , Wo          , Wo          
Gg          , Gg          , Ww          , Ww          , Hh          , Gg          , Hh          , Gg          , Rd          , Re^Gvs      , Gg^Vh       , Re^Gvs      , Re^Gvs      , Gg          , Gg          , Gg          , Gg          , Gg          , Gg          , Hh^Fms      , Hh^Fms      , Gs^Fds      , Gg          , Gg          , Hh          , Mm          , Mm          , Mm          , Mm          , Mm          , Mm          , Mm          , Mm          , Mm          , Mm          , Mm          , Mm          , Hh          , Hh^Fds      , Gg          , Gg          , Gg          , Gg          , Rd          , Gg          , Gg          , Gg          , Gg          , Gg          , Gg          , Ww          , Wo          , Wo          , Wo          , Wo          , Wo          , Wo          
Ww          , Ww          , Hh          , Gg          , Hh          , Hh          , Hh^Fms      , Hh^Fms      , Rd          , Re^Gvs      , Re^Gvs      , Re^Gvs      , Re^Gvs      , Gg          , Gg          , Gg          , Gs^Fds      , Gg          , Hh^Fms      , Hh^Fms      , Hh^Fms      , Gs^Fds      , Gg          , Gg          , Hh          , Mm          , Mm          , Mm          , Mm          , Mm          , Mm          , Mm          , Mm          , Mm          , Mm          , Mm          , Mm          , Mm          , Hh          , Gg          , Gg          , Gg          , Gg          , Rd          , Gg          , Gg          , Gg          , Ss          , Ss          , Gg          , Ww          , Ww          , Ww          , Wo          , Wo          , Wo          , Wo          
Gg          , Hh          , Hh          , Hh          , Hh          , Hh^Fms      , Hh^Fms      , Hh          , Rd          , Re^Gvs      , Re^Gvs      , Re^Gvs      , Gg          , Gg          , Gg          , Gg          , Gs^Fds      , Gg          , Gg          , Hh^Fms      , Hh^Fms      , Hh^Fms      , Hh          , Hh          , Mm          , Mm          , Mm          , Mm          , Mm          , Mm          , Mm          , Mm          , Mm^Xm       , Mm          , Mm          , Mm          , Hh          , Hh          , Hh          , Hh          , Hh          , Gg          , Gg          , Rd          , Gg          , Gg          , Ss          , Ss          , Ss          , Ww          , Ww          , Ww          , Wo          , Ww          , Wo          , Wo          , Wo          
Hh          , Hh          , Gg          , Gg          , Hh          , Hh^Fms      , Hh          , Gg          , Gg          , Rd          , Gg          , Gg          , Gg          , Gg          , Gs^Fds      , Gs^Fds      , Gs^Fds      , Gg          , Hh^Fms      , Gg          , Hh          , Mm          , Mm          , Mm          , Ce          , Ce          , Ce          , Mm^Vhh      , Mm          , Mm          , Mm^Xm       , Mm^Xm       , Mm^Xm       , Mm          , Mm          , Mm          , Mm          , Mm          , Mm          , Hh          , Hh          , Gg          , Rd          , Rd          , Ss          , Ss          , Ss          , Ss          , Ww          , Ww          , Wo          , Wo          , Wo          , Wo          , Wo          , Wo          , Wo          
Hh          , Hh          , Gg          , Hh          , Hh          , Hh^Fms      , Hh          , Gg          , Rr          , Rd          , Gg          , Gg          , Gg          , Gs^Fds      , Hh^Fms      , Hh^Fms      , Hh^Fms      , Hh^Fms      , Hh          , Hh^Fms      , Hh          , Hh          , Mm          , Mm          , Ce          , 3 Ke        , Ce          , Mm          , Mm          , Mm          , Mm^Xm       , Mm^Xm       , Mm^Xm       , Mm^Xm       , Mm          , Mm          , Hh          , Mm          , Mm          , Hh          , Hh          , Hh          , Rd          , Gg          , Ss          , Gg          , Ss          , Ss          , Ww          , Ww          , Wo          , Ww          , Wo          , Wo          , Wo          , Wo          , Wo          
Hh          , Hh          , Gg          , Hh          , Hh          , Hh          , Rp          , Rp^Vhc      , Rr          , Rr          , Rr          , Gg          , Gg          , Hh^Fms      , Hh^Fms      , Hh          , Hh          , Hh          , Hh          , Hh          , Mm          , Mm          , Mm          , Mm          , Mm^Vhh      , Ce          , Mm          , Mm          , Mm          , Mm          , Mm^Xm       , Mm^Xm       , Mm^Xm       , Mm^Xm       , Mm^Xm       , Mm          , Mm          , Hh          , Hh          , Mm          , Mm          , Ss          , Rd^Bw|      , Ss          , Hh          , Gg          , Ss          , Ss          , Ww          , Ww          , Wo          , Ww          , Wo          , Wo          , Wo          , Wo          , Wo          
Hh          , Hh^Fms      , Hh          , Gg          , Hh          , Rp^Vhc      , Rr          , Rr          , Rp          , Rp^Vhc      , Rr          , Rp^Vhc      , Gg          , Hh^Fms      , Hh^Fms      , Hh          , Mm          , Mm          , Mm          , Mm          , Mm          , Mm          , Mm          , Mm          , Mm          , Mm          , Mm          , Mm          , Mm          , Mm          , Mm^Xm       , Mm^Xm       , Mm^Xm       , Mm^Xm       , Mm^Xm       , Mm^Xm       , Mm^Xm       , Hh          , Hh          , Hh          , Hh          , Ss          , Rd          , Hh          , Gg          , Gg          , Gg          , Ss          , Ww          , Gg          , Wo          , Wo          , Ww          , Wo          , Wo          , Wo          , Wo          
Hh          , Hh^Fms      , Hh^Fms      , Hh^Fms      , Hh          , Rr          , Rr          , Rp^Vhc      , Rr          , Rr          , Rp^Vhc      , Gg          , Hh          , Hh          , Mm          , Mm^Vhh      , Mm          , Mm          , Mm          , Mm          , Mm          , Mm          , Mm          , Mm          , Mm          , Mm          , Mm          , Mm          , Mm          , Mm^Vhh      , Mm^Xm       , Mm^Xm       , Mm^Xm       , Mm^Xm       , Mm^Xm       , Mm^Xm       , Mm^Xm       , Mm^Xm       , Mm^Xm       , Hh          , Mm          , Hh          , Rd          , Gg          , Hh          , Gg          , Gg          , Gg          , Ww          , Ww          , Wo          , Wo          , Ww          , Wo          , Wo          , Wo          , Wo          
Hh          , Hh^Fms      , Hh^Fms      , Gg          , Hh^Fms      , Gg          , Gg          , Rr          , Rp^Vhc      , Gg          , Gg          , Gg          , Hh          , Hh          , Mm          , Mm          , Mm          , Mm          , Mm          , Mm          , Mm          , Mm          , Mm          , Mm          , Mm          , Mm          , Mm          , Mm          , Mm          , Mm          , Mm^Xm       , Mm^Xm       , Mm^Xm       , Mm^Xm       , Mm^Xm       , Mm^Xm       , Mm^Xm       , Mm^Xm       , Mm^Xm       , Mm          , Mm          , Hh          , Rd          , Hh          , Hh          , Hh          , Mm          , Hh          , Gg          , Ww          , Wo          , Ww          , Ww          , Ww          , Wo          , Wo          , Wo          
Hh          , Hh          , Hh          , Hh^Fms      , Hh          , Hh^Fms      , Hh          , Rd          , Gg          , Gg          , Hh          , Hh          , Hh          , Hh          , Mm          , Mm          , Mm          , Mm          , Mm          , Mm          , Mm          , Mm          , Mm          , Mm          , Mm          , Mm          , Mm          , Mm          , Mm^Xm       , Mm^Xm       , Mm^Xm       , Mm^Xm       , Mm^Xm       , Mm^Xm       , Mm^Xm       , Mm^Xm       , Mm^Xm       , Mm^Xm       , Mm^Xm       , Mm          , Mm          , Mm          , Rd          , Mm          , Mm          , Mm          , Mm          , Hh          , Ww          , Ww          , Wo          , Ww          , Wo          , Wo          , Wo          , Wo          , Wo          
