border_size=1
usage=map

Uu          , Uu          , Uu          , Uu          , Qxu         , Qxu         , Qxu         , Qxu         , Qxu         , Qxu         , Qxu         , Xu          , Xu          , Xu          , Xu          , Xu          , Xu          , Xu          , Xu          , Xu          , Xu          , Uh          , Uh          , Xu          , Ur          , Xu          , Uu          
Uu          , 4 Kud       , Cud         , Uu^Vu       , Qxu         , Qxu         , Xu          , Qxu         , Qxu         , Qxu         , Qxu         , Qxu         , Xu          , Xu          , Xu          , Xu          , Xu          , Xu          , Xu          , Xu          , Xu          , Uh          , Ur          , Ur          , Uu^Vu       , Uu          , Xu          
Uu          , Uu^Vu       , Uu^Vu       , Qxu         , Qxu         , Qxu         , Xu          , Qxu         , Qxu         , Xu          , Qxu         , Qxu         , Xu          , Xu          , Xu          , Xu          , Uh          , Uh          , Uh          , Uu          , Ur          , Ur          , Uu^Vu       , Uu^Vu       , Uu          , Uu          , Xu          
Qxu         , Uu^Vu       , Qxu         , Qxu         , Qxu         , Qxu         , Xu          , Qxu         , Qxu         , Qxu         , Xu          , Qxu         , Qxu         , Xu          , Qxu         , Qxu         , Qxu^Bs/     , Uu          , Uu          , Uu          , Ur          , Uu          , Uh          , Uh          , Uh          , Uh          , Xu          
Qxu         , Qxu         , Qxu         , Qxu         , Xu          , Qxu         , Xu          , Qxu         , Xu          , Xu          , Qxu         , Qxu         , Qxu         , Qxu         , Uu          , Uu          , Qxu         , Qxu         , Ur          , Ur          , Uu          , Uu          , Xu          , Uh          , Qxu         , Xu          , Xu          
Xu          , Xu          , Xu          , Xu          , Xu          , Xu          , Qxu         , Qxu         , Xu          , Xu          , Uu          , Uu          , Uu          , Uu          , Uu          , Uu^Vu       , Ur          , Qxu^Bs/     , Qxu         , Uu          , Qxu         , Qxu         , Qxu         , Qxu         , Qxu         , Qxu         , Xu          
Xu          , Qxu         , Qxu         , Qxu         , Qxu         , Qxu         , Qxu         , Xu          , Uu          , Uu          , Ur          , Ur          , Ur          , Uu^Vu       , Ur          , Ur          , Uu          , Qxu         , Qxu         , Qxu         , Qxu         , Qxu         , Qxu         , Xu          , Qxu         , Xu          , Xu          
Xu          , Xu          , Xu          , Qxu         , Qxu         , Qxu         , Xu          , Xu          , Uu          , Ur          , Xu          , Uu^Vu       , Uh          , Ur          , Uu^Vu       , Uu          , Uu          , Xu          , Qxu         , Qxu         , Qxu         , Qxu         , Qxu         , Qxu         , Qxu         , Qxu         , Xu          
Xu          , Xu          , Qxu         , Qxu         , Qxu         , Qxu         , Uu          , Uu          , Uu          , Ur          , Uu          , Uh          , Uh          , Uh          , Uu          , Xu          , Uu          , Uu          , Xu          , Xu          , Xu          , Xu          , Qxu         , Qxu         , Qxu         , Qxu         , Xu          
Xu          , Qxu         , Qxu         , Qxu         , Uu          , Uh          , Uu          , Xu          , Ur          , Ur          , Uu          , Uh          , Uu          , Uu          , Uu          , Xu          , Xu          , Uu          , Qxu         , Xu          , Xu          , Xu          , Qxu         , Xu          , Xu          , Xu          , Xu          
Xu          , Qxu         , Qxu         , Uu          , Uh          , Uh          , Ur          , Ur          , Uu          , Uu          , Qxu         , Xu          , Qxu         , Xu          , Qxu         , Qxu         , Qxu         , Qxu         , Qxu         , Qxu         , Qxu         , Qxu         , Xu          , Xu          , Qxu         , Qxu         , Qxu         
Qxu         , Qxu         , Uu          , Uu          , Uu          , Ur          , Uu          , Uu^Vu       , Xu          , Uu          , Qxu         , Qxu         , Qxu         , Qxu         , Qxu         , Qxu         , Qxu         , Qxu         , Qxu         , Qxu         , Qxu         , Qxu         , Qxu         , Qxu         , Xu          , Qxu         , Xu          
Xu          , Qxu         , Uh          , Uu          , Ur          , Ur          , Uu          , Uu          , Qxu         , Qxu^Bs|     , Xu          , Qxu         , Xu          , Xu          , Uu          , Qxu         , Qxu         , Qxu         , Qxu         , Qxu         , Qxu         , Qxu         , Xu          , Xu          , Uu^Vu       , Uu^Vu       , Xu          
Xu          , Qxu         , Uh          , Uh          , Ur          , Uu          , Qxu         , Qxu         , Qxu         , Uu          , Xu          , Xu          , Ur          , Uu          , Ur          , Uu          , Uu          , Uu          , Uu          , Qxu         , Qxu         , Qxu         , Xu          , Uu^Vu       , Cud         , 5 Kud       , Qxu         
Xu          , Qxu         , Uh          , Uh          , Qxu         , Ur          , Qxu^Bs\     , Qxu         , Uu          , Uu          , Ur          , Ur          , Uu          , Ur          , Uu          , Ur          , Uu^Vu       , Uu          , Uu          , Uu          , Qxu         , Qxu         , Qxu         , Xu          , Xu          , Uu^Vu       , Xu          
Xu          , Qxu         , Qxu         , Qxu         , Qxu         , Qxu         , Uu          , Ur          , Ur          , Ur          , Uu          , Uu          , Uu          , Uu          , Xu          , Ur          , Ur          , Uu          , Uu          , Xu          , Qxu         , Qxu         , Xu          , Qxu         , Xu          , Xu          , Xu          
Xu          , Qxu         , Qxu         , Qxu         , Qxu         , Qxu         , Qxu         , Uu          , Qxu         , Uu          , Xu          , Uu          , Xu          , Xu          , Xu          , Uu          , Ur          , Uu          , Xu          , Xu          , Qxu         , Qxu         , Qxu         , Qxu         , Xu          , Xu          , Xu          
Qxu         , Qxu         , Qxu         , Qxu         , Qxu         , Qxu         , Qxu         , Qxu         , Qxu         , Xu          , Xu          , Xu          , Xu          , Xu          , Uu          , Uu          , Ur          , Uu          , Xu          , Xu          , Xu          , Qxu         , Qxu         , Qxu         , Qxu         , Xu          , Xu          
Qxu         , Qxu         , Qxu         , Qxu         , Qxu         , Qxu         , Qxu         , Qxu         , Xu          , Xu          , Xu          , Xu          , Uu          , Xu          , Uu          , Uu          , Ur          , Uu          , Xu          , Xu          , Xu          , Xu          , Qxu         , Qxu         , Qxu         , Qxu         , Xu          
Qxu         , Qxu         , Qxu         , Qxu         , Qxu         , Qxu         , Qxu         , Qxu         , Xu          , Xu          , Uu          , Uu          , Uu          , Uu          , Xu          , Ur          , Ur          , Uu          , Uu          , Xu          , Qxu         , Xu          , Xu          , Xu          , Qxu         , Qxu         , Qxu         
Qxu         , Qxu         , Qxu         , Qxu         , Qxu         , Qxu         , Qxu         , Xu          , Xu          , Xu          , Uu          , Uu          , Uu          , Uu^Vu       , Ur          , Ur          , Uu^Vu       , Uu          , Uu          , Uu          , Qxu         , Qxu         , Qxu         , Xu          , Qxu         , Qxu         , Qxu         
Qxu         , Qxu         , Qxu         , Qxu         , Qxu         , Qxu         , Xu          , Xu          , Qxu         , Uu          , Uu          , Uu          , Uu          , Uu          , Ur          , Xu          , Uu          , Uu          , Xu          , Uu          , Qxu         , Qxu         , Qxu         , Qxu         , Qxu         , Qxu         , Qxu         
Xu          , Qxu         , Xu          , Qxu         , Qxu         , Uh          , Uh          , Xu          , Qxu         , Xu          , Xu          , Uu          , Uu          , Ur          , Uu          , Uu          , Xu          , Xu          , Xu          , Xu          , Xu          , Qxu         , Xu          , Qxu         , Qxu         , Qxu         , Qxu         
Xu          , Xu          , Uh          , Uh          , Qxu         , Qxu         , Uh          , Xu          , Qxu         , Xu          , Xu          , Uu          , Ur          , Ur          , Uu          , Uu          , Xu          , Xu          , Qxu         , Qxu         , Qxu         , Xu          , Qxu         , Xu          , Xu          , Xu          , Xu          
Xu          , Xu          , Uh          , Uh          , Uh          , Qxu         , Uh          , Uh          , Qxu         , Qxu         , Xu          , Uu          , Ur          , Uu          , Xu          , Qxu         , Qxu         , Qxu         , Qxu         , Qxu         , Qxu         , Qxu         , Qxu         , Xu          , Xu          , Xu          , Qxu         
Xu          , Xu          , Xu          , Uh          , Qxu         , Uh          , Uu          , Qxu         , Qxu         , Xu          , Uu          , Uu          , Ur          , Uu          , Xu          , Qxu         , Qxu         , Qxu         , Qxu         , Qxu         , Qxu         , Qxu         , Qxu         , Qxu         , Qxu         , Xu          , Qxu         
Xu          , Xu          , Xu          , Uh          , Uu          , Uh          , Qxu         , Qxu         , Uu          , Uu          , Uu          , Uu          , Xu          , Ur          , Cud         , Xu          , Xu          , Xu          , Xu          , Xu          , Xu          , Qxu         , Qxu         , Qxu         , Qxu         , Qxu         , Qxu         
Xu          , Xu          , Uh          , Uh          , Uh          , Uh          , Uh          , Uh          , Xu          , Xu          , Uu          , Uu          , Ur          , Cud         , Kud         , Xu          , Xu          , Xu          , Xu          , Xu          , Xu          , Qxu         , Qxu         , Qxu         , Qxu         , Qxu         , Qxu         
Xu          , Xu          , Xu          , Uh          , Uu          , Uh          , Uu          , Uu^Vu       , Xu          , Xu          , Ur          , Ur          , Xu          , Cud         , Xu          , Xu          , Xu          , Xu          , Xu          , Xu          , Xu          , Qxu         , Qxu         , Qxu         , Qxu         , Qxu         , Qxu         
Xu          , Xu          , Uu^Vu       , Xu          , Uu^Vu       , Uu          , Ur          , Ur          , Ur          , Ur          , Uu          , Uu          , Xu          , Xu          , Xu          , Xu          , Xu          , Xu          , Xu          , Xu          , Xu          , Qxu         , Qxu         , Qxu         , Qxu         , Qxu         , Qxu         
Xu          , Xu          , Cud         , 2 Kud       , Cud         , Ur          , Uu          , Uu          , Uu          , Uu          , Uu          , Uu          , Qxu         , Xu          , Xu          , Xu          , Xu          , Xu          , Xu          , Xu          , Qxu         , Qxu         , Qxu         , Qxu         , Qxu         , Qxu         , Qxu         
Xu          , Xu          , Uu^Vu       , Cud         , Ur          , Uu          , Uu          , Uu          , Uu          , Uu          , Xu          , Uu          , Qxu         , Xu          , Xu          , Xu          , Qxu         , Qxu         , Qxu         , Qxu         , Qxu         , Qxu         , Qxu         , Qxu         , Qxu         , Qxu         , Qxu         
Xu          , Xu          , Xu          , Uu          , Ur          , Uu          , Uu^Vu       , Uu          , Xu          , Xu          , Xu          , Xu          , Qxu         , Xu          , Qxu         , Qxu         , Qxu         , Qxu         , Qxu         , Qxu         , Qxu         , Qxu         , Qxu         , Qxu         , Qxu         , Qxu         , Uu          
Xu          , Xu          , Uu          , Uu          , Ur          , Xu          , Xu          , Xu          , Xu          , Xu          , Xu          , Qxu         , Qxu         , Xu          , Qxu         , Qxu         , Qxu         , Qxu         , Qxu         , Qxu         , Qxu         , Qxu         , Qxu         , Qxu         , Uu^Vu       , Uu          , Uu          
Xu          , Uu          , Ur          , Ur          , Uu          , Xu          , Xu          , Xu          , Xu          , Xu          , Xu          , Xu          , Qxu         , Qxu         , Xu          , Xu          , Qxu         , Qxu         , Qxu         , Qxu         , Qxu         , Qxu         , Uu          , Cud         , 3 Kud       , Uu          , Uu          
Xu          , Uu          , 1 Ur        , Uu          , Xu          , Xu          , Xu          , Xu          , Xu          , Xu          , Xu          , Xu          , Xu          , Xu          , Xu          , Xu          , Xu          , Qxu         , Qxu         , Qxu         , Qxu         , Qxu         , Uu          , Uu^Vu       , Uu^Vu       , Uu^Vu       , Uu          
Ur          , Ur          , Xu          , Uu          , Xu          , Xu          , Xu          , Xu          , Xu          , Xu          , Xu          , Xu          , Xu          , Xu          , Xu          , Xu          , Xu          , Qxu         , Xu          , Qxu         , Qxu         , Qxu         , Uu          , Uu          , Uu          , Uu          , Qxu         
