border_size=1
usage=map

Xu          , Xu          , Xu          , Xu          , Uh          , Uh          , Uh          , Ur          , Ur          , Xu          , Uu          , Uu          , Uu          , Uh          , Uh          , Xu          , Xu          , Xu          , Xu          , Xu          , Ww          , Ww          , Ww          , Xu          , Xu          , Xu          , Xu          
Xu          , Xu          , Xu          , Uh          , Uh          , Uh          , Uu^Vu       , Ur          , Ur          , Xu          , Uu          , Uu          , Uu          , Uh          , Uh          , Uh          , Xu          , Xu          , Xu          , Ww          , Ww          , Ww          , Xu          , Xu          , Xu          , Xu          , Xu          
Xu          , Xu          , Xu          , Xu          , Xu          , Uh          , Uh          , Uh          , Uu^Vu       , Ur          , Ur          , Ycud        , 2 Ykud      , Ycud        , Uh          , Uh          , Xu          , Xu          , Uu^Vu       , Ww          , Ww          , Xu          , Uh          , Xu          , Xu          , Xu          , Xu          
Xu          , Xu          , Xu          , Xu          , Xu          , Xu          , Uh          , Uu          , Xu          , Ur          , Ur          , Ycud        , Uu          , Ycud        , Uu          , Uh          , Xu          , Xu          , Xu          , Ww          , Uu          , Uu          , Cud         , Uu^Vu       , Cud         , Xu          , Xu          
Xu          , Xu          , Xu          , Xu          , Xu          , Xu          , Xu          , Uh          , Uh          , Xu          , Ur          , Uu          , Uu          , Uu          , Xu          , Uh          , Uu          , Xu          , Xu          , Ww          , Ww          , Uu          , Cud         , 1 Kud       , Cud         , Xu          , Xu          
Xu          , Xu          , Xu          , Xu          , Xu          , Xu          , Uh          , Uh          , Uu          , Xu          , Ur          , Xu          , Uu          , Uu          , Uu          , Uu^Vu       , Xu          , Xu          , Uu^Vu       , Ww          , Ww          , Uu          , Uu          , Uh          , Xu          , Xu          , Xu          
Xu          , Xu          , Xu          , Xu          , Xu          , Xu          , Xu          , Uu          , Uu          , Uu          , Ur          , Xu          , Uu^Vu       , Uu          , Uu          , Xu          , Xu          , Xu          , Xu          , Uu          , Ww          , Uu          , Xu          , Uu^Vu       , Xu          , Xu          , Xu          
Xu          , Xu          , Xu          , Xu          , Xu          , Xu          , Xu          , Xu          , Uu          , Uu^Vu       , Ur          , Xu          , Xu          , Uu          , Uu          , Xu          , Xu          , Xu          , Xu          , Uu          , Uu          , Ww          , Uu          , Uu          , Xu          , Xu          , Xu          
Xu          , Xu          , Xu          , Xu          , Xu          , Xu          , Xu          , Xu          , Uu          , Uu          , Ur          , Xu          , Uu          , Uu          , Xu          , Xu          , Xu          , Xu          , Xu          , Uu          , Uu          , Ww          , Xu          , Xu          , Xu          , Xu          , Xu          
Xu          , Xu          , Xu          , Xu          , Xu          , Xu          , Xu          , Xu          , Uu          , Xu          , Ur          , Ur          , Uh          , Uu^Vu       , Xu          , Xu          , Xu          , Xu          , Xu          , Uu          , Ww          , Ww          , Uu^Vu       , Xu          , Xu          , Xu          , Xu          
Xu          , Xu          , Xu          , Xu          , Xu          , Xu          , Xu          , Xu          , Ur          , Ur          , Ur          , Uu          , Uu          , Xu          , Xu          , Xu          , Xu          , Xu          , Xu          , Ww          , Uu^Vu       , Ww          , Ww          , Xu          , Xu          , Xu          , Xu          
Xu          , Xu          , Xu          , Xu          , Xu          , Xu          , Xu          , Ur          , Xu          , Ur          , Xu          , Xu          , Uu          , Xu          , Xu          , Xu          , Uu          , Uu^Vu       , Uu          , Ww          , Uu          , Uu          , Ww          , Xu          , Xu          , Xu          , Xu          
Xu          , Xu          , Xu          , Xu          , Xu          , Xu          , Xu          , Ur          , Ur          , Uu^Vu       , Uu          , Uh          , Uh          , Xu          , Xu          , Xu          , Uu          , Uu          , Wwf         , Ww          , Uu          , Ww          , Xu          , Xu          , Xu          , Xu          , Xu          
Xu          , Xu          , Xu          , Xu          , Xu          , Xu          , Xu          , Ur          , Ur          , Uu          , Uh          , Xu          , Uh          , Uh          , Xu          , Xu          , Uu          , Uu          , Wwf         , Uu          , Uu          , Ww          , Xu          , Xu          , Xu          , Xu          , Xu          
Xu          , Xu          , Xu          , Xu          , Uu          , Uu          , Uu          , Xu          , Ur          , Uu          , Uh          , Xu          , Uh          , Uh          , Xu          , Xu          , Uu^Vu       , Wwf         , Xu          , Ww          , Ww          , Ww          , Xu          , Xu          , Xu          , Xu          , Xu          
Xu          , Xu          , Xu          , Xu          , Uu          , Xu          , Uu          , Xu          , Ur          , Uu          , Uu          , Uh          , Uu          , Uh          , Uh          , Xu          , Xu          , Wwf         , Ww          , Ww          , Ww          , Xu          , Xu          , Xu          , Xu          , Xu          , Xu          
Xu          , Xu          , Xu          , Xu          , Uu          , Xu          , Uu^Vu       , Ur          , Uu          , Uu          , Uh          , Uh          , Xu          , Uu          , Uu          , Uu          , Ww          , Ww          , Uu^Uf       , Ww          , Xu          , Xu          , Xu          , Xu          , Xu          , Xu          , Xu          
Xu          , Xu          , Xu          , Uu          , Uu          , Uu          , Uu          , Ur          , Uu          , Uu          , Uh          , Uh          , Uh          , Uu          , Xu          , Ww          , Ww          , Uu^Uf       , Uu          , Xu          , Xu          , Xu          , Xu          , Xu          , Uu          , Xu          , Ur          
Xu          , Xu          , Uu          , Uu          , Uu          , Uu          , Uu          , Ur          , Uu          , Xu          , Uh          , Uh          , Uh          , Wwf         , Ww          , Ww          , Uu^Uf       , Uu          , Xu          , Xu          , Xu          , Xu          , Uu          , Uu          , Ur          , Ur          , Xu          
Xu          , Xu          , Xu          , Xu          , Uu          , Xu          , Uu          , Ur          , Uu          , Uh          , Uh          , Uh          , Xu          , Uu^Uf       , Ww          , Ww          , Uu^Uf       , Xu          , Xu          , Xu          , Xu          , Uu^Vu       , Ur          , Ur          , Uu          , Xu          , Xu          
Xu          , Xu          , Xu          , Xu          , Xu          , Uu          , Uu          , Ur          , Uu          , Uh          , Uh          , Xu          , Xu          , Xu          , Ww          , Ww          , Xu          , Xu          , Xu          , Xu          , Uu          , Ur          , Uu          , Uu          , Xu          , Xu          , Xu          
Xu          , Xu          , Xu          , Xu          , Ww          , Uu^Uf       , Ur          , Ur          , Uu          , Uu          , Uh          , Xu          , Xu          , Xu          , Ww          , Uu^Uf       , Xu          , Xu          , Uu          , Uu          , Ur          , Ur          , Xu          , Xu          , Xu          , Xu          , Xu          
Xu          , Xu          , Xu          , Ww          , Ww          , Ww          , Ur          , Xu          , Xu          , Uu          , Xu          , Xu          , Ww          , Ww          , Uu^Uf       , Uu          , Uu          , Uu          , Ur          , Ur          , Uu          , Uu          , Xu          , Xu          , Xu          , Xu          , Xu          
Xu          , Xu          , Xu          , Xu          , Uu^Uf       , Wwf         , Xu          , Ur          , Ur          , Uu^Uf       , Uu^Uf       , Ww          , Ww          , Ww          , Wwf         , Xu          , Xu          , Xu          , Ur          , Ur          , Uu^Vu       , Uu          , Xu          , Xu          , Xu          , Xu          , Xu          
Xu          , Xu          , Xu          , Uu          , Ur          , Uu^Uf       , Uu^Vu       , Uu          , Ur          , Uu          , Uu^Uf       , Ww          , Uu^Uf       , Ww          , Uu          , Xu          , Xu          , Xu          , Ur          , Xu          , Uu          , Uu          , Uu          , Xu          , Xu          , Xu          , Xu          
Ur          , Xu          , Ur          , Ur          , Uu          , Ur          , Ur          , Ur          , Ur          , Ur          , Ur          , Ww          , Ww          , Ww          , Uu          , Uu          , Ur          , Ur          , Ur          , Xu          , Uu          , Uu          , Uu          , Xu          , Xu          , Xu          , Xu          
Xu          , Ur          , Xu          , Uu          , Xu          , Uu          , Uu^Vu       , Uu          , Uu          , Ur          , Ww          , Wwf         , Ur          , Wwf         , Ur          , Uu          , Ur          , Xu          , Ur          , Uu          , Uu          , Uu          , Uu          , Uu^Vu       , Xu          , Xu          , Xu          
Xu          , Xu          , Xu          , Xu          , Xu          , Xu          , Xu          , Uu          , Uu^Uf       , Ww          , Ww          , Ww          , Ww          , Wwf         , Ur          , Ur          , Uu          , Ur          , Uu          , Uu          , Uu          , Uu          , Uu          , Xu          , Xu          , Xu          , Xu          
Xu          , Xu          , Xu          , Xu          , Xu          , Xu          , Xu          , Xu          , Uu^Uf       , Ww          , Ww          , Uu          , Ww          , Uu^Vu       , Uu          , Uu          , Xu          , Xu          , Uu          , Uu          , Uu          , Uu          , Xu          , Xu          , Xu          , Xu          , Xu          
Xu          , Xu          , Xu          , Xu          , Xu          , Xu          , Xu          , Xu          , Ww          , Ww          , Ww          , Ww          , Uu^Uf       , Uu^Uf       , Uu^Vu       , Uu          , Uu          , Uu          , Uu^Vu       , Uu          , Xu          , Xu          , Xu          , Xu          , Xu          , Xu          , Xu          
Xu          , Xu          , Xu          , Xu          , Xu          , Xu          , Xu          , Xu          , Ww          , Ww          , Xu          , Xu          , Xu          , Xu          , Xu          , Xu          , Xu          , Xu          , Xu          , Xu          , Xu          , Xu          , Xu          , Xu          , Xu          , Xu          , Xu          
Xu          , Xu          , Xu          , Xu          , Xu          , Xu          , Xu          , Xu          , Ww          , Xu          , Xu          , Xu          , Xu          , Xu          , Xu          , Xu          , Xu          , Xu          , Xu          , Xu          , Xu          , Xu          , Xu          , Xu          , Xu          , Xu          , Xu          
