border_size=1
usage=map

Xu          , Xu          , Xu          , Xu          , Uh          , Uh          , Uh          , Ur          , Ur          , Xu          , Uu          , Uu          , Uu          , Uh          , Uh          , Xu          , Xu          , Xu          , Xu          , Xu          , Uu          , Ww          , Uu          , Xu          , Xu          , Xu          , Xu          
Xu          , Xu          , Xu          , Uh          , Xu          , Uh          , Uu^Vu       , Ur          , Ur          , Xu          , Xu          , Uu          , Uu^Vu       , Uh          , Uh          , Uh          , Xu          , Xu          , Xu          , Xu          , Uu          , Ww          , Uu          , Uu          , Uu          , Uu^Vu       , Xu          
Xu          , Xu          , Xu          , Xu          , Xu          , Uh          , Uh          , Uh          , Ur          , Ur          , Ur          , Cud         , 2 Kud       , Cud         , Uh          , Uh          , Xu          , Xu          , Xu          , Uu          , Uu          , Ww          , Ww          , Uu          , Cud         , Uu          , Xu          
Xu          , Xu          , Xu          , Xu          , Xu          , Xu          , Uh          , Xu          , Xu          , Ur          , Ur          , Cud         , Uu^Vu       , Cud         , Uu          , Uh          , Xu          , Xu          , Xu          , Uu^Vu       , Uu          , Uu          , Ww          , Ww          , Cud         , Uu          , Xu          
Xu          , Xu          , Xu          , Xu          , Xu          , Xu          , Xu          , Uh          , Uh          , Xu          , Ur          , Xu          , Uu          , Uu          , Xu          , Uh          , Uu          , Xu          , Xu          , Xu          , Uu          , Uu          , Ww          , 1 Kud       , Cud         , Uu          , Xu          
Xu          , Xu          , Xu          , Xu          , Xu          , Xu          , Uh          , Uh          , Xu          , Xu          , Ur          , Xu          , Uu          , Uu          , Xu          , Uu^Vu       , Xu          , Xu          , Uu^Vu       , Uu          , Ww          , Ww          , Uu          , Cud         , Uu          , Uu          , Xu          
Xu          , Xu          , Xu          , Xu          , Xu          , Xu          , Xu          , Xu          , Xu          , Uu^Vu       , Ur          , Xu          , Uu^Vu       , Uu          , Uu          , Xu          , Xu          , Xu          , Xu          , Uu          , Uu          , Ww          , Xu          , Uu          , Uu^Vu       , Xu          , Xu          
Xu          , Xu          , Xu          , Xu          , Xu          , Xu          , Xu          , Xu          , Xu          , Uu^Vu       , Ur          , Xu          , Xu          , Xu          , Uu          , Xu          , Xu          , Xu          , Xu          , Uu          , Uu          , Ww          , Xu          , Xu          , Xu          , Xu          , Xu          
Xu          , Xu          , Xu          , Xu          , Xu          , Xu          , Xu          , Xu          , Xu          , Xu          , Ur          , Xu          , Uu          , Uu          , Xu          , Xu          , Xu          , Xu          , Xu          , Uu          , Uu          , Ww          , Xu          , Xu          , Xu          , Xu          , Xu          
Xu          , Xu          , Xu          , Xu          , Xu          , Xu          , Xu          , Xu          , Xu          , Xu          , Ur          , Ur          , Xu          , Uu^Vu       , Xu          , Xu          , Xu          , Xu          , Xu          , Uu          , Uu          , Ww          , Uu^Vu       , Xu          , Xu          , Xu          , Xu          
Xu          , Xu          , Xu          , Xu          , Xu          , Xu          , Xu          , Xu          , Ur          , Ur          , Ur          , Xu          , Xu          , Xu          , Xu          , Xu          , Xu          , Xu          , Xu          , Uu          , Uu          , Ww          , Ww          , Xu          , Xu          , Xu          , Xu          
Xu          , Xu          , Xu          , Xu          , Xu          , Xu          , Xu          , Ur          , Xu          , Ur          , Xu          , Xu          , Xu          , Xu          , Xu          , Xu          , Xu          , Xu          , Uu          , Uu          , Uu          , Uu          , Ww          , Xu          , Xu          , Xu          , Xu          
Xu          , Xu          , Xu          , Xu          , Xu          , Xu          , Xu          , Ur          , Ur          , Uu^Vu       , Uh          , Uh          , Uh          , Xu          , Xu          , Xu          , Xu          , Uu^Vu       , Uu          , Uu          , Uu          , Ww          , Xu          , Xu          , Xu          , Xu          , Xu          
Xu          , Xu          , Xu          , Xu          , Xu          , Xu          , Xu          , Ur          , Ur          , Uh          , Uh          , Xu          , Uh          , Uh          , Xu          , Xu          , Xu          , Xu          , Uu          , Uu          , Ww          , Ww          , Xu          , Xu          , Xu          , Xu          , Ur          
Xu          , Xu          , Xu          , Xu          , Uu          , Uu          , Uu          , Xu          , Ur          , Uh          , Uh          , Xu          , Uh          , Xu          , Xu          , Xu          , Uu          , Uu          , Xu          , Uu          , Ww          , Xu          , Xu          , Xu          , Ur          , Ur          , Xu          
Xu          , Xu          , Xu          , Xu          , Uu          , Uu^Dr       , Uu          , Xu          , Ur          , Uh          , Uh          , Uh          , Xu          , Xu          , Xu          , Xu          , Xu          , Uu          , Ww          , Ww          , Ww          , Xu          , Xu          , Xu          , Ur          , Xu          , Xu          
Xu          , Xu          , Xu          , Xu          , Uu          , Xu          , Uu^Vu       , Ur          , Uh          , Uh          , Uh          , Uh          , Xu          , Xu          , Xu          , Xu          , Ww          , Ww          , Uu          , Ww          , Xu          , Xu          , Xu          , Ur          , Ur          , Xu          , Xu          
Xu          , Xu          , Xu          , Uu          , Uu          , Uu          , Uu          , Ur          , Uh          , Uh          , Uh          , Uh          , Xu          , Xu          , Xu          , Ww          , Ww          , Uu          , Uu          , Xu          , Xu          , Xu          , Xu          , Ur          , Ur          , Xu          , Xu          
Xu          , Xu          , Uu          , Uu          , Uu          , Uu          , Uu          , Ur          , Uu          , Xu          , Uh          , Uh          , Uh          , Xu          , Ww          , Ww          , Uu          , Uu          , Xu          , Xu          , Xu          , Xu          , Ur          , Ur          , Xu          , Xu          , Xu          
Xu          , Xu          , Uu          , Xu          , Uu          , Xu          , Uu          , Uu          , Uu          , Uh          , Uh          , Uh          , Xu          , Xu          , Ww          , Xu          , Uu          , Xu          , Xu          , Xu          , Xu          , Uu          , Ur          , Xu          , Xu          , Xu          , Xu          
Xu          , Xu          , Xu          , Xu          , Xu          , Uu          , Uu          , Uu          , Uu          , Uh          , Uh          , Xu          , Xu          , Xu          , Ww          , Ww          , Xu          , Xu          , Xu          , Xu          , Uu          , Ur          , Uu          , Xu          , Xu          , Xu          , Xu          
Xu          , Xu          , Xu          , Xu          , Xu          , Uu          , Uu          , Uu          , Uu          , Uu          , Uh          , Xu          , Xu          , Xu          , Ww          , Uu          , Xu          , Xu          , Uu          , Uu          , Ur          , Ur          , Xu          , Xu          , Xu          , Xu          , Xu          
Xu          , Xu          , Xu          , Xu          , Xu          , Xu          , Uu          , Xu          , Xu          , Uu          , Xu          , Xu          , Ww          , Ww          , Uu          , Uu          , Uu          , Uu          , Ur          , Ur          , Uu          , Uu          , Xu          , Xu          , Xu          , Xu          , Xu          
Xu          , Xu          , Xu          , Xu          , Uu          , Xu          , Xu          , Uu          , Uu          , Uu          , Uu          , Ww          , Ww          , Ww          , Ww          , Xu          , Xu          , Xu          , Ur          , Ur          , Uu          , Uu          , Xu          , Xu          , Xu          , Xu          , Xu          
Xu          , Xu          , Xu          , Uu          , Ur          , Uu          , Uu^Vu       , Uu          , Ur          , Uu          , Uu          , Ww          , Uu          , Ww          , Uu          , Xu          , Xu          , Xu          , Ur          , Xu          , Uu          , Uu          , Uu          , Xu          , Xu          , Xu          , Xu          
Ur          , Xu          , Ur          , Ur          , Uu          , Ur          , Ur          , Ur          , Ur          , Ur          , Uu          , Ww          , Ww          , Ww          , Uu          , Uu          , Uu          , Ur          , Uu          , Xu          , Uu          , Xu          , Uu          , Xu          , Xu          , Xu          , Xu          
Xu          , Ur          , Xu          , Uu          , Xu          , Uu          , Uu^Vu       , Uu          , Uu          , Uu          , Ww          , Wwf         , Ur          , Wwf         , Ur          , Uu          , Ur          , Xu          , Uu          , Uu          , Uu          , Xu          , Uu          , Uu          , Uu          , Xu          , Xu          
Xu          , Xu          , Xu          , Xu          , Xu          , Xu          , Xu          , Uu          , Uu          , Ww          , Ww          , Ww          , Ww          , Wwf         , Ur          , Ur          , Uu          , Uu          , Uu          , Uu          , Xu          , Xu          , Xu          , Uu          , Uu          , Xu          , Xu          
Xu          , Xu          , Xu          , Xu          , Xu          , Xu          , Xu          , Xu          , Uu          , Ww          , Ww          , Uu          , Ww          , Uu          , Uu          , Uu          , Xu          , Uu          , Uu          , Xu          , Xu          , Xu          , Xu          , Xu          , Uu          , Xu          , Xu          
Xu          , Xu          , Xu          , Xu          , Xu          , Xu          , Xu          , Xu          , Ww          , Ww          , Ww          , Ww          , Uu          , Uu          , Xu          , Xu          , Xu          , Xu          , Xu          , Uu          , Uu          , Uu          , Uu          , Uu          , Xu          , Xu          , Xu          
Xu          , Xu          , Xu          , Xu          , Xu          , Xu          , Xu          , Xu          , Ww          , Ww          , Xu          , Xu          , Xu          , Uu^Vu       , Xu          , Xu          , Xu          , Xu          , Xu          , Xu          , Xu          , Xu          , Xu          , Xu          , Xu          , Xu          , Xu          
Xu          , Xu          , Xu          , Xu          , Xu          , Xu          , Xu          , Xu          , Ww          , Ww          , Xu          , Xu          , Xu          , Xu          , Xu          , Xu          , Xu          , Xu          , Xu          , Xu          , Xu          , Xu          , Xu          , Xu          , Xu          , Xu          , Xu          
