border_size=1
usage=map

Xu          , Xu          , Xu          , Xu          , Uh          , Uh          , Uh          , Ur          , Ur          , Xu          , Uu          , Uu          , Uu          , Uh          , Uh          , Xu          , Xu          , Xu          , Xu          , Xu          , Yww         , Yww         , Yww         , Xu          , Xu          , Xu          , Xu          
Xu          , Xu          , Xu          , Uh          , Uh          , Uh          , Uu^Vu       , Ur          , Ur          , Xu          , Uu          , Uu          , Uu          , Uh          , Uh          , Uh          , Xu          , Xu          , Xu          , Yww         , Yww         , Yww         , Xu          , Xu          , Xu          , Xu          , Xu          
Xu          , Xu          , Xu          , Xu          , Xu          , Uh          , Uh          , Uh          , Uu^Vu       , Ur          , Ur          , Cud         , 2 Kud       , Cud         , Uh          , Uh          , Xu          , Xu          , Uu^Vu       , Yww         , Yww         , Xu          , Cud         , Xu          , Cud         , Xu          , Xu          
Xu          , Xu          , Xu          , Xu          , Xu          , Xu          , Uh          , Uu          , Xu          , Ur          , Ur          , Cud         , Uu          , Cud         , Uu          , Uh          , Xu          , Xu          , Xu          , Yww         , Uu          , Uu          , Cud         , 1 Kud       , Cud         , Xu          , Xu          
Xu          , Xu          , Xu          , Xu          , Xu          , Xu          , Xu          , Uh          , Uh          , Xu          , Ur          , Uu          , Uu          , Uu          , Xu          , Uh          , Uu          , Xu          , Xu          , Yww         , Yww         , Uu          , Uu^Vu       , Uu^Vu       , Uu          , Xu          , Xu          
Ur          , Uu          , Ur          , Uu          , Uu          , Xu          , Uh          , Uh          , Uu          , Xu          , Ur          , Xu          , Uu          , Uu          , Uu          , Uu^Vu       , Xu          , Xu          , Uu^Vu       , Yww         , Yww         , Uu          , Uu          , Uh          , Xu          , Xu          , Uu          
Xu          , Ur          , Uu          , Ur          , Ur          , Uu          , Xu          , Uu          , Uu          , Uu          , Ur          , Xu          , Uu^Vu       , Uu          , Uu          , Xu          , Xu          , Xu          , Xu          , Uu          , Yww         , Uu          , Xu          , Uu^Vu       , Uu          , Uu          , Xu          
Xu          , Xu          , Xu          , Uu          , Uu          , Ur          , Ur          , Xu          , Uh          , Uu^Vu       , Ur          , Xu          , Xu          , Uu          , Uu          , Xu          , Xu          , Xu          , Xu          , Uu          , Uu          , Yww         , Uu          , Uu          , Xu          , Xu          , Xu          
Xu          , Xu          , Xu          , Uh          , Xu          , Uu          , Uu          , Ur          , Ur          , Uu          , Ur          , Xu          , Uu          , Uu          , Xu          , Xu          , Xu          , Xu          , Xu          , Uu          , Uu          , Yww         , Xu          , Xu          , Xu          , Xu          , Xu          
Xu          , Xu          , Xu          , Xu          , Xu          , Xu          , Xu          , Xu          , Ur          , Xu          , Ur          , Ur          , Uh          , Uu^Vu       , Xu          , Xu          , Xu          , Xu          , Xu          , Uu          , Yww         , Yww         , Uu^Vu       , Xu          , Xu          , Xu          , Xu          
Xu          , Xu          , Xu          , Xu          , Xu          , Xu          , Xu          , Xu          , Ur          , Ur          , Ur          , Uu          , Uu          , Xu          , Xu          , Xu          , Xu          , Xu          , Xu          , Yww         , Uu^Vu       , Yww         , Yww         , Xu          , Xu          , Xu          , Xu          
Xu          , Xu          , Xu          , Xu          , Xu          , Xu          , Xu          , Ur          , Xu          , Ur          , Xu          , Xu          , Uu          , Xu          , Xu          , Xu          , Uu          , Uu^Vu       , Uu          , Yww         , Uu          , Uu          , Yww         , Xu          , Xu          , Xu          , Xu          
Xu          , Xu          , Xu          , Xu          , Xu          , Xu          , Xu          , Ur          , Ur          , Uu^Vu       , Uu          , Uh          , Uh          , Xu          , Xu          , Xu          , Uu          , Uu          , Ywwf        , Yww         , Uu          , Yww         , Xu          , Xu          , Xu          , Xu          , Xu          
Xu          , Xu          , Xu          , Xu          , Xu          , Xu          , Xu          , Ur          , Ur          , Uu          , Uh          , Xu          , Uh          , Uh          , Xu          , Xu          , Uu          , Uu          , Ywwf        , Uu          , Uu          , Yww         , Xu          , Xu          , Xu          , Xu          , Xu          
Xu          , Xu          , Xu          , Xu          , Uu          , Uu          , Uu          , Xu          , Ur          , Uu          , Uh          , Xu          , Uh          , Uh          , Xu          , Xu          , Uu^Vu       , Ywwf        , Xu          , Yww         , Yww         , Yww         , Xu          , Xu          , Xu          , Xu          , Xu          
Xu          , Xu          , Xu          , Xu          , Uu          , Xu          , Uu          , Xu          , Ur          , Uu          , Uu          , Uh          , Uu          , Uh          , Uh          , Xu          , Xu          , Ywwf        , Yww         , Yww         , Yww         , Xu          , Xu          , Xu          , Xu          , Xu          , Xu          
Xu          , Xu          , Xu          , Xu          , Uu          , Xu          , Uu^Vu       , Ur          , Uu          , Uu          , Uh          , Uh          , Xu          , Uu          , Uu          , Uu          , Yww         , Yww         , Uu^Uf       , Yww         , Xu          , Xu          , Xu          , Xu          , Xu          , Xu          , Xu          
Xu          , Xu          , Xu          , Uu          , Uu          , Uu          , Uu          , Ur          , Uu          , Uu          , Uh          , Uh          , Uh          , Uu          , Xu          , Yww         , Yww         , Uu^Uf       , Uu          , Xu          , Xu          , Xu          , Xu          , Xu          , Uu          , Xu          , Ur          
Xu          , Xu          , Uu          , Uu          , Uu          , Uu          , Uu          , Ur          , Uu          , Xu          , Uh          , Uh          , Uh          , Ywwf        , Yww         , Yww         , Uu^Uf       , Uu          , Xu          , Xu          , Xu          , Xu          , Uu          , Uu          , Ur          , Ur          , Xu          
Xu          , Xu          , Xu          , Xu          , Uu          , Xu          , Uu          , Ur          , Uu          , Uh          , Uh          , Uh          , Xu          , Uu^Uf       , Yww         , Yww         , Uu^Uf       , Xu          , Xu          , Xu          , Xu          , Uu^Vu       , Ur          , Ur          , Uu          , Xu          , Xu          
Xu          , Xu          , Xu          , Xu          , Xu          , Uu          , Uu          , Ur          , Uu          , Uh          , Uh          , Xu          , Xu          , Xu          , Yww         , Yww         , Xu          , Xu          , Xu          , Xu          , Uu          , Ur          , Uu          , Uu          , Xu          , Xu          , Xu          
Xu          , Xu          , Xu          , Xu          , Yww         , Uu^Uf       , Ur          , Ur          , Uu          , Uu          , Uh          , Xu          , Xu          , Xu          , Yww         , Uu^Uf       , Xu          , Xu          , Uu          , Uu          , Ur          , Ur          , Xu          , Xu          , Xu          , Xu          , Xu          
Xu          , Xu          , Xu          , Yww         , Yww         , Yww         , Ur          , Xu          , Xu          , Uu          , Xu          , Xu          , Yww         , Yww         , Uu^Uf       , Uu          , Uu          , Uu          , Ur          , Ur          , Uu          , Uu          , Xu          , Xu          , Xu          , Xu          , Xu          
Xu          , Xu          , Xu          , Xu          , Uu^Uf       , Ywwf        , Xu          , Ur          , Ur          , Uu^Uf       , Uu^Uf       , Yww         , Yww         , Yww         , Ywwf        , Xu          , Xu          , Xu          , Ur          , Ur          , Uu^Vu       , Uu          , Xu          , Xu          , Xu          , Xu          , Xu          
Xu          , Xu          , Xu          , Uu          , Ur          , Uu^Uf       , Uu^Vu       , Uu          , Ur          , Uu          , Uu^Uf       , Yww         , Uu^Uf       , Yww         , Uu          , Xu          , Xu          , Xu          , Ur          , Xu          , Uu          , Uu          , Uu          , Xu          , Xu          , Xu          , Xu          
Ur          , Xu          , Ur          , Ur          , Uu          , Ur          , Ur          , Ur          , Ur          , Ur          , Ur          , Yww         , Yww         , Yww         , Uu          , Uu          , Ur          , Ur          , Ur          , Xu          , Uu          , Uu          , Uu          , Xu          , Xu          , Xu          , Xu          
Xu          , Ur          , Xu          , Uu          , Xu          , Uu          , Uu^Vu       , Uu          , Uu          , Ur          , Yww         , Ywwf        , Ur          , Ywwf        , Ur          , Uu          , Ur          , Xu          , Ur          , Uu          , Uu          , Uu          , Uu          , Uu^Vu       , Xu          , Xu          , Xu          
Xu          , Xu          , Xu          , Xu          , Xu          , Xu          , Xu          , Uu          , Uu^Uf       , Yww         , Yww         , Yww         , Yww         , Ywwf        , Ur          , Ur          , Uu          , Ur          , Uu          , Uu          , Uu          , Uu          , Uu          , Xu          , Xu          , Xu          , Xu          
Xu          , Xu          , Xu          , Xu          , Xu          , Xu          , Xu          , Xu          , Uu^Uf       , Yww         , Yww         , Uu          , Yww         , Uu^Vu       , Uu          , Uu          , Xu          , Xu          , Uu          , Uu          , Uu          , Uu          , Xu          , Xu          , Xu          , Xu          , Xu          
Xu          , Xu          , Xu          , Xu          , Xu          , Xu          , Xu          , Xu          , Yww         , Yww         , Yww         , Yww         , Uu^Uf       , Uu^Uf       , Uu^Vu       , Uu          , Uu          , Uu          , Uu^Vu       , Uu          , Xu          , Xu          , Xu          , Xu          , Xu          , Xu          , Xu          
Xu          , Xu          , Xu          , Xu          , Xu          , Xu          , Xu          , Xu          , Yww         , Yww         , Xu          , Xu          , Xu          , Xu          , Xu          , Xu          , Xu          , Xu          , Xu          , Xu          , Xu          , Xu          , Xu          , Xu          , Xu          , Xu          , Xu          
Xu          , Xu          , Xu          , Xu          , Xu          , Xu          , Xu          , Xu          , Yww         , Xu          , Xu          , Xu          , Xu          , Xu          , Xu          , Xu          , Xu          , Xu          , Xu          , Xu          , Xu          , Xu          , Xu          , Xu          , Xu          , Xu          , Xu          
