border_size=1
usage=map

Wo          , Wo          , Wo          , Ww          , Wwf         , Uu          , Uu          , Uu          , Yww         , Yww         , Uu          , Yww         , Uu          , Uu          
Wo          , Uu          , Wo          , Wo          , Wwf         , Uu          , Uu          , Yww         , Yww         , Yww         , Yww         , Yww         , Uu          , Uu          
Ur          , Wo          , Ww          , Ww          , Uu          , Uu          , Uu          , Yww         , Ywwf        , Uu          , Uh          , Uh          , Uu          , Uu          
Ur          , Ur          , Ur          , Uu          , Uu          , Uu          , Uu          , Uu          , Ywwf        , Uu          , Uh          , Uh          , Uu          , Uu          
Ywur        , Ywur        , Ywur        , Ywur        , Ywu         , Ywu         , Ywu         , Yww         , Yww         , Yww         , Ywuh        , Ywuh        , Ywu^Uf      , Uu          
Yww         , Yww         , Yww         , Yww         , Yww         , Yww         , Yww         , Yww         , Yww         , Ywo         , Yww         , Yww         , Yww         , Ywuh        
Xu          , Yww         , Yww         , Yww         , Yww         , Yww         , Yww         , Yww         , Yww         , Ywo         , Yww         , Yww         , Yww         , Yww         
Xu          , Ywo         , Ywo         , Yww         , Ywo         , Yww         , Ywo         , Yww         , Ywo         , Ywo         , Ywo         , Yww         , Ywo         , Yww         
Xu          , Xu          , Ywo         , Ywo         , Ywo         , Ywo         , Ywo         , Ywo         , Ywo         , Ywo         , Ywo         , Ywo         , Ywo         , Ywo         
Xu          , Xu          , Ywo         , Ywo         , Ywo         , Ywo         , Ywo         , Ywo         , Ywo         , Ywo         , Ywo         , Ywo         , Ywo         , Ywo         
