border_size=1
usage=map

Ms          , Ms          , Ms          , Ms          , Ms          , Ms          , Ms          , Ms          , Ms          , Ms          , Ms          , Ms          , Ms          , Ms          , Ms          , Ms          , Ms          , Ms          , Ms          , Ms          , Ms          , Ms          , Ms          , Ha          , Ha          , Ha          , Ha          , Ha          , Ms          , Ha          , Ms          , Ms          
Ms          , Ms          , Ms          , Ms          , Ms          , Ms          , Ms          , Ms          , Ms          , Ai          , Ms          , Ai          , Ms          , Ai          , Ms          , Ms          , Ms          , Ms          , Ms          , Ms          , Ms          , Ha          , Ha          , Ms          , Ms          , Ms          , Ha          , Ms          , Ha          , Ms          , Ms          , Ms          
Ms          , Ms          , Ms          , Ms          , Ms          , Ms          , Ms          , Ms          , Ms          , Ms          , Ms          , Ms          , Ms          , Aa          , Ai          , Aa          , Ms          , Ms          , Ms          , Ha^Fpa      , Ha^Fpa      , Ha          , Ms          , Ha          , Ms          , Ms          , Ms          , Ms          , Ms          , Ms          , Ms          , Ms          
Ms          , Ha^Cov      , Ms          , Aa          , Ms          , Ms          , Ms          , Aa          , Ms          , Rr^Vd       , Rr          , Rr^Vd       , Ha          , Ms          , Ms          , Ms          , Ms          , Ms          , Ha^Fpa      , Ha^Fpa      , Ha^Fpa      , Ha^Fpa      , Ms          , Ms          , Ha^Fpa      , Aa          , Aa          , Ms          , Ms          , Ms          , Ms          , Ms          
Aa^Kov      , Ha^Cov      , Ha          , Aa          , Aa          , Ms          , Ai          , Ha          , Ms          , Rr^Xo       , Rr          , Rr^Xo       , Ha          , Ms          , Ms          , Aa          , Aa          , Ai          , Ms          , Ai          , Ha^Fpa      , Ha^Fpa      , Ha^Fpa      , Ha^Fpa      , Ha^Fpa      , Ms          , Ms          , Ms          , Ms          , Ms          , Ha          , Ms          
Aa          , Ms          , Aa          , Aa          , Ms          , Ha^Fpa      , Aa          , Ha          , Ha          , Rr^Vd       , Rr          , Rr^Vd       , Ha          , Ha          , Ms          , Ai          , Ai          , Ai          , Ai          , Ai          , Ai          , Ha^Fpa      , Ha^Fpa      , Ha^Fpa      , Ms          , Ms          , Ms          , Ms          , Ms          , Ms          , Ha          , Ms          
Aa          , Aa          , Aa          , Ms          , Ms          , Ha^Fpa      , Ha          , Chr         , Ms          , Rr          , Rr          , Rr          , Ha          , Chr         , Aa          , Ai          , Ai          , Ww          , Ww          , Ai          , Ai          , Aa          , Chr         , Chr         , Chr         , Ms          , Ms          , Aa          , Ms          , Ha          , Ha          , Ai          
Ms          , Aa          , Aa          , Aa          , Aa          , Aa^Fpa      , Ha          , Ha          , Ha          , Aa          , Rr^Vd       , Aa          , Ha          , Ha          , Aa          , Aa          , Ai          , Ai          , Ai          , Ai          , Aa          , Ai          , Aa          , 3 Khr       , Ha          , Chr         , Ha          , Ms          , Ms          , Ha          , Ha          , Ms          
Ms          , Aa          , Aa          , Ms          , Ms          , Aa^Fpa      , Aa^Fpa      , Aa          , Ha          , Chr         , Rr          , Chr         , Ha          , Ms          , Aa          , Ms          , Aa          , Ms          , Ai          , Ms          , Aa          , Aa          , Aa          , Aa          , Aa          , Aa          , Ha          , Ms          , Ha^Voa      , Ms          , Ms          , Ms          
Ms          , Aa          , Ms          , Ms          , Ms          , Aa^Fpa      , Ms          , Ms          , Aa          , Aa          , Rr          , Aa          , Aa          , Ms          , Ms          , Aa          , Ms          , Ms          , Aa^Voa      , Aa          , Ms          , Ms          , Aa          , Ms          , Ms          , Aa          , Ms          , Ha          , Ms          , Ms          , Ms          , Ms          
Ms          , Ms          , Ha          , Ms          , Ms          , Ms          , Aa^Fpa      , Ms          , Aa          , Ms          , Rr          , Ms          , Ms          , Aa          , Aa          , Ms          , Aa          , Aa          , Aa          , Ms          , Ms          , Ms          , Ms          , Ms          , Aa          , Ms          , Aa          , Ms          , Ms          , Ms          , Ms          , Ms          
Ha          , Ha          , Chr         , Ha          , Ha          , Ms          , Ms          , Ms          , Ms          , Ha          , Aa          , Ha          , Aa          , Ms          , Ms          , Ms          , Ms          , Aa          , Ms          , Ms          , Ms          , Ms          , Ms          , Ms          , Ms          , Ha^Voa      , Ms          , Ms          , Ms          , Ms          , Ms          , Ms          
Ha          , Chr         , Ms          , 2 Khr       , Ha          , Ms          , Ms          , Ms          , Ms          , Ha          , Aa          , Ha          , Aa          , Aa          , Ms          , Ms          , Aa          , Ms          , Aa          , Ms          , Ms          , Ms          , Ms          , Aa          , Ms          , Ha          , Ms          , Ms          , Ms          , Ms          , Ms          , Ha^Fpa      
Aa          , Ha          , Chr         , Chr         , Ha          , Aa          , Aa^Voa      , Ms          , Ms          , Ha          , Aa          , Ha          , Aa          , Aa          , Ms          , Ms          , Ms          , Ms          , Aa          , Ms          , Ms          , Ms          , Ms          , Ms          , Ms          , Ms          , Ms          , Ms          , Ms          , Ms          , Ms          , Aa^Fpa      
Aa          , Aa          , Aa          , Aa          , Aa          , Aa          , Ms          , Ms          , Ms          , Ms          , Aa          , Ms          , Aa          , Aa^Voa      , Ms          , Aa          , Ms          , Ms          , Aa          , Aa          , Ms          , Ms          , Ms          , Ms          , Ha          , Ha          , Ha^Voa      , Ms          , Ms          , Ha^Fpa      , Ha^Fpa      , Aa^Fpa      
Ms          , Ms          , Aa          , Ha          , Ha^Voa      , Ha          , Ms          , Ms          , Ms          , Ms          , Aa          , Aa          , Aa          , Aa          , Aa          , Aa          , Ms          , Ms          , Ai          , Aa          , Ha^Voa      , Ms          , Ms          , Ms          , Ms          , Ms          , Ms          , Ms          , Ms          , Ha^Fpa      , Aa^Fpa      , Aa^Fpa      
Ha          , Ha          , Ha          , Ha          , Ms          , Ms          , Ha          , Ms          , Ms          , Aa          , Aa          , Aa          , Aa^Voa      , Aa          , Aa^Voa      , Aa          , Ms          , Aa          , Ai          , Ms          , Ms          , Ms          , Ms          , Ms          , Ms          , Ms          , Ms          , Ms          , Ms          , Ms          , Aa          , Ms          
Ha          , Ha          , Ms          , Ha          , Ms          , Ms          , Ha          , Ha          , Ms          , Aa          , Aa          , Ms          , Ms          , Ms          , Ai          , Ai          , Ai          , Ai          , Aa          , Ha          , Ha          , Ha          , Ms          , Ha^Fpa      , Ha          , Ms          , Aa^Fpa      , Ms          , Aa          , Ms          , Aa          , Aa          
Ha          , Ha          , Ha          , Ha          , Ha          , Ha          , Ha          , Ha          , Ha          , Ha          , Aa          , Aa          , Ms          , Ai          , Ww          , Ww          , Ai          , Ai          , Ha          , Ms          , Ms          , Ms          , Ha^Fpa      , Ha^Fpa      , Ha^Fpa      , Ha          , Aa^Fpa      , Aa          , Aa^Fpa      , Ms          , Aa          , Aa          
Ms          , Ms          , Ms          , Aa          , Ms          , Aa          , Ms          , Ms          , Ms          , Ms          , Ha          , Ms          , Aa          , Ms          , Ai          , Ww          , Ms          , Ai          , Ha          , Ms          , Ms          , Ha          , Ha          , Ha          , Ha          , Ha          , Aa          , Aa          , Gs^Fp       , Aa^Fpa      , Aa^Fpa      , Aa          
Ms          , Aa          , Aa          , Aa          , Aa          , Aa          , Ms          , Ms          , Ms          , Ms          , Ms          , Ms          , Ms          , Ms          , Ai          , Ai          , Ms          , Ms          , Ha          , Ha^Voa      , Ha          , Ha          , Ha          , Ms          , Ms          , Ai          , Gg          , Aa^Fpa      , Gs^Fp       , Aa^Fpa      , Aa^Fpa      , Aa          
Aa          , Ms          , Ms          , Aa          , Aa          , Ms          , Aa          , Ms          , Ms          , Ms          , Ms          , Ms          , Ms          , Ms          , Ai          , Ai          , Ai          , Ai          , Ai          , Ai          , Ha          , Ms          , Ms          , Ai          , Ww          , Ww          , Ww          , Gs^Fp       , Gs^Fp       , Aa^Fpa      , Aa^Fpa      , Aa          
Aa          , Ms          , Ms          , Aa          , Ms          , Ms          , Ms          , Ms          , Ms          , Ms          , Ms          , Ms          , Ms          , Ms          , Ms          , Ai          , Ms          , Ai          , Ms          , Ms          , Ai          , Ww          , Ai          , Ms          , Ms          , Ww          , Ww          , Aa^Fpa      , Gg          , Aa          , Aa^Fpa      , Aa^Fpa      
Aa          , Aa          , Aa          , Aa          , Ha          , Ha          , Ms          , Ms          , Ms          , Ms          , Ms          , Ms          , Ms          , Ms          , Ms          , Ww          , Ms          , Ms          , Ai          , Ai          , Ai          , Ai          , Ai          , Ms          , Ms          , Ms          , Gg          , Gg          , Aa^Fpa      , Aa^Fpa      , Aa^Fpa      , Aa^Fpa      
Aa          , Ms          , Aa          , Ms          , Ha          , Ha          , Ms          , Ms          , Ms          , Ms          , Ms          , Ms          , Ms          , Ms          , Ms          , Ai          , Ms          , Ms          , Ms          , Ms          , Ai          , Ms          , Ms          , Ms          , Ms          , Ms          , Ai          , Gg          , Aa^Fpa      , Aa^Fpa      , Aa^Fpa      , Ai          
Ms          , Ms          , Ms          , Ms          , Ms          , Ha          , Ms          , Ms          , Ms          , Ms          , Ms          , Ms          , Ai          , Ai          , Ai          , Ai          , Ms          , Ms          , Ms          , Ms          , Ms          , Ms          , Ms          , Ms          , Ms          , Ms          , Aa^Fpa      , Aa^Fpa      , Aa^Fpa      , Aa^Fpa      , Aa          , Aa^Fpa      
Ms          , Ms          , Ms          , Ms          , Ms          , Ms          , Ms          , Ha          , Ms          , Ms          , Ms          , Ha          , Ai          , Ww          , Ms          , Ms          , Ms          , Ms          , 4 Ha^Kov    , Ha          , Ms          , Ms          , Ms          , Ms          , Ms          , Aa^Fpa      , Aa^Fpa      , Aa^Fpa      , Aa          , Aa^Fpa      , Aa^Fpa      , Aa^Fpa      
Ms          , Ms          , Ms          , Aa          , Ms          , Aa          , Ms          , Ha          , Ha^Voa      , Ha          , Ha          , Ms          , Ai          , Ha          , Ms          , Ms          , Ms          , Ha^Cov      , Ha^Cov      , Ha^Cov      , Ms          , Ha          , Ha          , Ha          , Ms          , Aa^Fpa      , Aa^Fpa      , Aa^Fpa      , Aa^Fpa      , Aa^Fpa      , Aa^Fpa      , Ai          
Ms          , Aa          , Aa          , Ms          , Aa          , Aa          , Ms          , Ha          , Ha          , Ha          , Ha          , Ha          , Ai          , Ha          , Ms          , Ms          , Ms          , Ha          , Ha^Fpa      , Ha          , Ha          , Ha          , Ha^Fpa      , Ha^Fpa      , Ha^Fpa      , Aa^Fpa      , Aa^Fpa      , Aa          , Aa^Fpa      , Aa^Fpa      , Aa          , Ai          
Aa          , Aa^Voa      , Ms          , Ms          , Aa          , Aa          , Aa          , Ha^Voa      , Ms          , Ms          , Ha          , Ha          , Ha          , Ai          , Ms          , Ms          , Ms          , Ms          , Ha          , Ms          , Ha^Voa      , Ha          , Ms          , Ha^Fpa      , Ms          , Aa^Fpa      , Aa          , Aa^Voa      , Aa^Fpa      , Aa          , Aa          , Ms          
Aa          , Aa          , Ms          , Ms          , Aa          , Aa          , Aa          , Ms          , Ms          , Ms          , Ha          , Ha          , Ha          , Ai          , Ww          , Ai          , Ai          , Ms          , Ms          , Ms          , Ha          , Ha          , Ms          , Ha          , Ha          , Ha          , Aa          , Aa          , Aa          , Aa          , Aa          , Aa          
Ha          , Ms          , Aa          , Aa          , Ms          , Aa          , Ms          , Ms          , Ms          , Ms          , Ha          , Ms          , Ha          , Ms          , Ww          , Ai          , Ms          , Ms          , Ms          , Ms          , Ha          , Ha          , Ms          , Ha          , Ha^Fpa      , Ha          , Aa          , Aa          , Aa^Fpa      , Aa^Fpa      , Gg          , Ai          
Ms          , Ms          , Ms          , Aa          , Aa          , Ms          , Ha^Voa      , Ms          , Ms          , Ms          , Ms          , Ms          , Ms          , Ms          , Ai          , Ww          , Ms          , Ms          , Ms          , Ms          , Ms          , Ms          , Ms          , Ha          , Aa          , Aa          , Gg          , Aa          , Aa^Fpa      , Aa^Fpa      , Gg          , Gg          
Ms          , Ms          , Ms          , Ms          , Ms          , Aa          , Ms          , Ms          , Ms          , Ms          , Ms          , Ms          , Ms          , Ms          , Ai          , Ms          , Ms          , Ms          , Ms          , Ms          , Ms          , Ms          , Ms          , Ms          , Aa          , Aa          , Aa          , Gg^Vo       , Aa          , Gg          , Ww          , Ww          
Ms          , Ms          , Ms          , Ms          , Ms          , Aa          , Aa          , Ms          , Ms          , Ms          , Ms          , Ms          , Ms          , Ms          , Ww          , Ww          , Ms          , Ms          , Ms          , Ms          , Ms          , Ms          , Aa          , Aa          , Aa          , Gg          , Ha          , Aa          , Gg          , Gg          , Ww          , Ww          
Ms          , Ms          , Ms          , Ms          , Aa          , Aa          , Aa          , Aa          , Aa          , Aa^Voa      , Aa          , Ms          , Ms          , Ms          , Ww          , Ai          , Ms          , Ms          , Ms          , Ms          , Ms          , Ms          , Aa^Fpa      , Ms          , Aa          , Ms          , Ms          , Gg          , Gg          , Ww          , Gg          , Ww          
Ms          , Ms          , Aa          , Aa          , Ms          , Aa          , Aa          , Aa          , Aa          , Aa          , Ms          , Ms          , Ms          , Ms          , Ai          , Ai          , Ms          , Ms          , Ms          , Ms          , Ms          , Aa          , Aa^Fpa      , Ms          , Gs^Fp       , Aa          , Aa          , Gg          , Gg          , Ww          , Gg          , Ww          
Ms          , Ms          , Aa          , Ms          , Aa          , Aa          , Aa          , Aa          , Ms          , Ms          , Aa          , Ms          , Ai          , Ai          , Ai          , Ms          , Ms          , Ms          , Ms          , Ms          , Ms          , Aa          , Aa^Fpa      , Aa^Fpa      , Aa^Fpa      , Gs^Fp       , Gs^Fp       , Aa          , Gg          , Ww          , Ww          , Ww          
Ms          , Ms          , Ms          , Aa          , Aa          , Aa^Voa      , Aa          , Aa          , Aa          , Aa          , Ms          , Ai          , Ww          , Ww          , Ms          , Ms          , Ms          , Ms          , Ms          , Ms          , Aa^Fpa      , Aa          , Aa          , Aa          , Aa^Fpa      , Aa          , Aa          , Gs^Fp       , Aa^Fpa      , Gg          , Ww          , Ww          
Ms          , Ms          , Ms          , Ms          , Aa          , Aa          , Ms          , Aa          , Ms          , Ms          , Ai          , Ww          , Ww          , Ms          , Aa          , Ms          , Ms          , Ms          , Ms          , Ms          , Aa^Fpa      , Aa^Fpa      , Aa^Fpa      , Aa^Fpa      , Aa^Fpa      , Gs^Fp       , Gs^Fp       , Gs^Fp       , Aa          , Gg          , Ww          , Ww          
Ms          , Ms          , Aa          , Aa          , Aa          , Aa          , Aa          , Ms          , Ms          , Ms          , Ai          , Ms          , Aa          , Aa          , Ms          , Aa          , Hh^Fp       , Aa          , Aa^Fpa      , Aa^Fpa      , Gg          , Aa          , Aa^Fpa      , Aa^Fpa      , Aa^Fpa      , Gs^Fp       , Gs^Fp       , Aa          , Gs^Fp       , Gg^Vo       , Ww          , Ww          
Ms          , Ms          , Ms          , Aa          , Ms          , Aa          , Aa          , Ms          , Ms          , Ms          , Ai          , Aa          , Aa          , Ha^Voa      , Mm          , Hh          , Hh^Fp       , Aa^Fpa      , Aa^Fpa      , Hh^Fp       , Hh^Fp       , Gg          , Aa^Fpa      , Aa^Fpa      , Aa          , Gs^Fp       , Aa^Fpa      , Aa          , Ww          , Ww          , Wo          , Ww          
Ms          , Ms          , Ms          , Ms          , Ms          , Ms          , Aa          , Ms          , Ms          , Ms          , Ms          , Ai          , Mm          , Mm          , Mm          , Hh          , Hh^Fp       , Aa^Fpa      , Hh^Fp       , Hh^Fp       , Gg          , Gg^Vo       , Aa^Fpa      , Aa^Fpa      , Co          , Gs^Fp       , Gg^Vo       , Ww          , Ww          , Ww          , Wo          , Wo          
Ms          , Ms          , Ms          , Ms          , Aa          , Aa          , Ms          , Ms          , Ms          , Ms          , Ai          , Ai          , Ai          , Mm          , Mm          , Hh          , Hh          , Hh^Fp       , Gg          , Hh^Fp       , Gg^Vo       , Gg          , Aa          , Aa^Fpa      , 1 Ko        , Co          , Gs^Fp       , Ww          , Ww          , Wo          , Wo          , Wo          
Ms          , Ms          , Aa          , Aa          , Ms          , Aa          , Ms          , Ms          , Ms          , Ms          , Ai          , Ww          , Ms          , Mm          , Mm          , Mm          , Hh          , Hh          , Hh          , Hh          , Hh          , Gg          , Gg          , Co          , Co          , Co          , Ww          , Ww          , Ww          , Ww          , Wo          , Wo          
Ms          , Ms          , Aa          , Ms          , Ms          , Ms          , Ms          , Ms          , Ms          , Ms          , Ms          , Ww          , Ww          , Mm          , Mm          , Mm          , Mm          , Mm          , Mm          , Hh          , Gg          , Gg^Vo       , Gg          , Gg          , Gg          , Ww          , Ww          , Ww          , Wo          , Wo          , Wo          , Wo          
Ms          , Ms          , Ms          , Aa          , Aa          , Aa          , Ms          , Ms          , Ms          , Ms          , Ms          , Ai          , Ww          , Ww          , Ms          , Mm          , Mm          , Mm          , Mm          , Gg          , Ww          , Ww          , Ww          , Ww          , Ww          , Ww          , Wo          , Wo          , Wo          , Wo          , Wo          , Wo          
