border_size=1
usage=map

Xu          , Xu          , Xu          , Xu          , Xu          , Xu          , Xu          , Xu          , Xu          , Xu          , Xu          , Xu          , Wo          , Wo          , Wo          , Xu          , Xu          , Xu          , Uu          , Uu          , Xu          , Xu          , Xu          , Xu          , Xu          , Xu          , Xu          , Xu          , Ur          , Xu          , Xu          , Xu          
Xu          , Xu          , Xu          , Xu          , Xu          , Xu          , Xu          , Xu          , Xu          , Xu          , Xu          , Xu          , Wo          , Xu          , Wo          , Xu          , Xu          , Xu          , Xu          , Uu          , Uu          , Xu          , Xu          , Xu          , Xu          , Xu          , Ur          , Ur          , Xu          , Xu          , Xu          , Xu          
Xu          , Xu          , Xu          , Xu          , Xu          , Xu          , Xu          , Xu          , Xu          , Xu          , Xu          , Xu          , Xu          , Wo          , Wo          , Wo          , Xu          , Xu          , Xu          , Uu^Vu       , Uu          , Xu          , Cud         , Cud         , Cud         , Ur          , Uu^Vu       , Xu          , Xu          , Xu          , Xu          , Xu          
Xu          , Xu          , Xu          , Xu          , Xu          , Xu          , Xu          , Xu          , Xu          , Xu          , Xu          , Xu          , Xu          , Wo          , Wo          , Wo          , Wo          , Xu          , Xu          , Xu          , Uu          , Xu          , Cud         , 4 Kud       , Uu^Vu       , Ur          , Xu          , Xu          , Xu          , Xu          , Xu          , Xu          
Xu          , Xu          , Xu          , Xu          , Xu          , Xu          , Xu          , Xu          , Xu          , Xu          , Xu          , Xu          , Xu          , Xu          , Wo          , Wo          , Wo          , Wo          , Xu          , Xu          , Xu          , Uu          , Uu^Vu       , Uu^Vu       , Xu          , Ur          , Xu          , Xu          , Xu          , Xu          , Xu          , Xu          
Xu          , Xu          , Xu          , Xu          , Xu          , Xu          , Xu          , Xu          , Xu          , Xu          , Xu          , Xu          , Xu          , Xu          , Wo          , Wo          , Wo          , Xu          , Xu          , Xu          , Xu          , Uu          , Xu          , Xu          , Cud         , Ur          , Cud         , Xu          , Xu          , Xu          , Xu          , Xu          
Xu          , Xu          , Xu          , Xu          , Xu          , Xu          , Xu          , Xu          , Xu          , Xu          , Xu          , Xu          , Xu          , Xu          , Wo          , Xu          , Wo          , Xu          , Xu          , Xu          , Cud         , Uu          , Cud         , Xu          , Ww          , Ww^Bw|      , Ww          , Ww          , Ww          , Ww          , Ww          , Xu          
Xu          , Xu          , Xu          , Xu          , Xu          , Xu          , Xu          , Xu          , Xu          , Xu          , Xu          , Xu          , Xu          , Xu          , Wo          , Wo          , Wo          , Wo          , Xu          , Xu          , Uu^Tf       , Uu          , Ww          , Ww          , Xu          , Ur          , Wwf         , Ww          , Ww          , Ww          , Ww          , Ww          
Xu          , Xu          , Xu          , Xu          , Xu          , Xu          , Xu          , Xu          , Xu          , Xu          , Xu          , Xu          , Xu          , Xu          , Xu          , Wo          , Wo          , Wo          , Wo^Bw/      , Uu          , Ww          , Ww          , Ww          , Ww          , Ww          , Ww^Bw|      , Xu          , Ww          , Xu          , Xu          , Cud         , Xu          
Xu          , Xu          , Xu          , Xu          , Xu          , Xu          , Xu          , Xu          , Xu          , Xu          , Xu          , Xu          , Xu          , Xu          , Xu          , Uu^Tf       , Uu          , Wo^Bw/      , Wo          , Wo          , Wo          , Ww          , Ww          , Xu          , Uu^Vud      , Uu^Tf       , Cud         , Uu^Vud      , Xu          , Uu^Vud      , Ur          , Ur          
Xu          , Xu          , Uu^Vu       , Xu          , Xu          , Xu          , Xu          , Xu          , Xu          , Xu          , Xu          , Xu          , Uh          , Xu          , Uh          , Uh          , Uh          , Uu^Tf       , Ww          , Ww          , Ww          , Ww          , Cud         , Xu          , Cud         , Cud         , 2 Kud       , Cud         , Ur          , Ur          , Uu^Vud      , Ur          
Xu          , Xu          , Uu^Vu       , Xu          , Uu          , Xu          , Xu          , Xu          , Xu          , Uu^Vu       , Uh          , Uh          , Xu          , Uh          , Uh          , Uh          , Xu          , Uu^Tf       , Uu^Tf       , Ww          , Ww          , Ww          , Uu          , Uu^Vud      , Uu^Tf       , Cud         , Cud         , Uu^Vud      , Xu          , Cud         , Xu          , Xu          
Uu          , Uu          , Xu          , Uu          , 3 Kud       , Cud         , Uu          , Uu^Vu       , Uu          , Uu          , Uu          , Uh          , Xu          , Uh          , Xu          , Uh          , Xu          , Uu          , Uu^Tf       , Wwf         , Ww^Bw/      , Ww^Bw/      , Ww          , Cud         , Uu^Tf       , Uu          , Uu^Tf       , Ur          , Xu          , Xu          , Qxu         , Qxu         
Uu          , Uu          , Uu          , Uu          , Cud         , Cud         , Cud         , Xu          , Uu          , Uu          , Uu          , Uu          , Uu          , Uu          , Uu          , Uu          , Uu          , Uu          , Uu          , Uu          , Uu^Tf       , Ww          , Ww^Bw/      , Wo^Bw/      , Ww          , Uu^Vu       , Xu          , Xu          , Qxu         , Qxu         , Qxu         , Qxu         
Xu          , Xu          , Uu          , Uu          , Xu          , Uu          , Uu          , Cud         , Uu          , Uh          , Uu          , Uu          , Uu          , Uu          , Uh          , Uh          , Uh          , Uu          , Uh          , Uu          , Xu          , Uu          , Wwf         , Ww          , Ww          , Uu^Tf       , Xu          , Qxu         , Xu          , Xu          , Xu          , Xu          
Xu          , Xu          , Xu          , Uu^Vu       , Uu^Vu       , Uu          , Uu          , Uu          , Uh          , Uu          , Uh          , Uu          , Uu^Vu       , Uu          , Uu          , Uu          , Uu^Tf       , Uu^Tf       , Uu^Tf       , Uu          , Xu          , Xu          , Xu          , Ww          , Ww          , Wo          , Xu          , Qxu         , Qxu         , Qxu         , Qxu         , Xu          
Xu          , Xu          , Xu          , Xu          , Xu          , Xu          , Xu          , Xu          , Xu          , Uu^Vu       , Xu          , Xu          , Xu          , Xu          , Xu          , Ww          , Wwf         , Wwf         , Wwf         , Xu          , Uu^Vu       , Xu          , Xu          , Ww          , Ww          , Wo          , Wo          , Xu          , Xu          , Xu          , Qxu         , Xu          
Xu          , Xu          , Xu          , Xu          , Xu          , Xu          , Xu          , Xu          , Xu          , Xu          , Xu          , Xu          , Xu          , Xu          , Xu          , Ww          , Ww          , Ww          , Wwf         , Wwf         , Ww          , Xu          , Ww          , Ww          , Ww          , Ww          , Wo          , Uu^Tf       , Uh          , Qxu         , Xu          , Xu          
Xu          , Xu          , Xu          , Xu          , Xu          , Xu          , Xu          , Xu          , Xu          , Xu          , Xu          , Xu          , Xu          , Xu          , Xu          , Xu          , Ww          , Ww          , Ww          , Ww          , Ww          , Ww          , Ww          , Ww          , Xu          , Ww          , Ww          , Wo          , Wo          , Xu          , Xu          , Xu          
Xu          , Xu          , Xu          , Xu          , Xu          , Xu          , Xu          , Xu          , Xu          , Xu          , Xu          , Xu          , Xu          , Xu          , Xu          , Xu          , Xu          , Ww          , Xu          , Ww          , Xu          , Ww          , Xu          , Xu          , Xu          , Uu^Tf       , Ww          , Wo          , Wo          , Xu          , Xu          , Xu          
Xu          , Xu          , Xu          , Xu          , Xu          , Xu          , Xu          , Xu          , Xu          , Xu          , Xu          , Xu          , Xu          , Xu          , Xu          , Xu          , Xu          , Xu          , Xu          , Xu          , Xu          , Xu          , Xu          , Xu          , Xu          , Ww          , Ww          , Ww          , Wo          , Xu          , Xu          , Xu          
Xu          , Xu          , Xu          , Xu          , Xu          , Xu          , Xu          , Xu          , Xu          , Xu          , Xu          , Xu          , Xu          , Xu          , Xu          , Xu          , Xu          , Xu          , Wwf         , Xu          , Xu          , Xu          , Xu          , Xu          , Xu          , Ww          , Ww          , Wo          , Xu          , Xu          , Xu          , Xu          
Xu          , Xu          , Xu          , Xu          , Xu          , Xu          , Xu          , Xu          , Xu          , Xu          , Xu          , Xu          , Xu          , Xu          , Xu          , Xu          , Wwf         , Wwf         , Ww          , Wwf         , Ww          , Xu          , Xu          , Xu          , Xu          , Ww          , Ww          , Wo          , Xu          , Xu          , Xu          , Xu          
Xu          , Xu          , Xu          , Xu          , Xu          , Xu          , Xu          , Xu          , Xu          , Xu          , Xu          , Xu          , Xu          , Xu          , Xu          , Wo          , Ww          , Ww          , Uu^Tf       , Ww          , Wo          , Ww          , Xu          , Xu          , Xu          , Ww          , Ww          , Wo          , Xu          , Xu          , Xu          , Xu          
Xu          , Xu          , Xu          , Xu          , Xu          , Xu          , Xu          , Xu          , Xu          , Xu          , Xu          , Xu          , Xu          , Xu          , Wo          , Wo          , Ww          , Ww          , Uu^Tf       , Uu^Tf       , Uu^Tf       , Wo          , Wo          , Xu          , Xu          , Ww          , Ww          , Wo          , Xu          , Xu          , Xu          , Xu          
Xu          , Xu          , Xu          , Xu          , Xu          , Xu          , Xu          , Xu          , Xu          , Xu          , Xu          , Xu          , Xu          , Wo          , Ww          , Ww          , Uu^Tf       , Uu^Tf       , Uu^Tf       , Uu^Tf       , Xu          , Wo          , Wo          , Xu          , Xu          , Ww          , Ww          , Wo          , Xu          , Xu          , Xu          , Xu          
Xu          , Xu          , Xu          , Xu          , Xu          , Xu          , Xu          , Xu          , Xu          , Xu          , Xu          , Xu          , Wo          , Wo          , Ww          , Ww          , Uu^Tf       , Uu^Tf       , Uu          , Uu          , Xu          , Xu          , Wo          , Wo          , Wo          , Wo          , Wo          , Wo          , Xu          , Xu          , Xu          , Xu          
Xu          , Xu          , Xu          , Xu          , Xu          , Xu          , Xu          , Xu          , Xu          , Xu          , Xu          , Xu          , Wo          , Wo          , Ww          , Uu^Tf       , Uu^Tf       , Uu^Tf       , Uu          , Uu          , Xu          , Xu          , Xu          , Wo          , Wo          , Wo          , Wo          , Wo          , Xu          , Xu          , Xu          , Xu          
Xu          , Xu          , Xu          , Xu          , Xu          , Xu          , Xu          , Xu          , Xu          , Xu          , Xu          , Xu          , Wo          , Ww          , Uu^Tf       , Uu^Tf       , Ce          , Uu          , Uu          , Xu          , Xu          , Xu          , Xu          , Xu          , Xu          , Xu          , Xu          , Xu          , Xu          , Xu          , Xu          , Xu          
Xu          , Xu          , Xu          , Xu          , Xu          , Xu          , Xu          , Xu          , Xu          , Xu          , Xu          , Wo          , Ww          , Ww          , Uu^Tf       , Ce          , 1 Ke        , Ce          , Uu          , Xu          , Xu          , Xu          , Xu          , Xu          , Xu          , Xu          , Xu          , Xu          , Xu          , Xu          , Xu          , Xu          
Xu          , Xu          , Xu          , Xu          , Xu          , Xu          , Xu          , Xu          , Xu          , Xu          , Wo          , Wo          , Ww          , Uu^Tf       , Uu          , Ce          , Xu          , Ce          , Xu          , Xu          , Xu          , Xu          , Xu          , Xu          , Xu          , Xu          , Xu          , Xu          , Xu          , Xu          , Xu          , Xu          
Xu          , Xu          , Xu          , Xu          , Xu          , Xu          , Xu          , Xu          , Xu          , Xu          , Wo          , Wo          , Ww          , Xu          , Xu          , Xu          , Xu          , Xu          , Xu          , Xu          , Xu          , Xu          , Xu          , Xu          , Xu          , Xu          , Xu          , Xu          , Xu          , Xu          , Xu          , Xu          
