border_size=1
usage=map

Ms          , Mm          , Ms          , Mm          , Ms          , Ms          , Ms          , Ms          , Ms          , Ms          , Ms          , Mm          , Mm          , Mm          , Mm          , Mm          , Mm          , Mm          , Mm          , Mm          , Ai          , Ai          , Ai          , Mm          , Hh          , Ms          , Ms          , Mm          , Mm          , Mm          , Mm          , Ms          , Ms          , Ms          , Ms          , Mm          , Mm          , Mm          , Mm          , Mm          , Mm          , Mm          
Mm          , Ms          , Ms          , Ms          , Ms          , Ms          , Ms          , Ms          , Ms          , Ms          , Ms          , Mm          , Ms          , Ms^Vhha     , Ms          , Mm          , Mm          , Mm          , Mm          , Mm          , Ha          , Ai          , Ai          , Ha          , Ha          , Ms          , Ms          , Mm          , Ms          , Mm          , Ms          , Ms          , Ms          , Ms          , Mm          , Mm          , Mm          , Mm          , Mm          , Ms^Vhha     , Mm          , Mm          
Ms          , Ms          , Ms          , Ms^Vhha     , Ms          , Ms          , Ms          , Ms          , Ms          , Mm          , Ms          , Mm          , Ms          , Ms          , Ms          , Mm          , Mm          , Ms          , Ms          , Mm          , Ha          , Hh          , Ai          , Ha          , Ms          , Ms          , Ms          , Ms          , Ms          , Mm          , Ms          , Ms          , Mm          , Mm          , Ms          , Ms          , Ms          , Ms          , Mm          , Mm          , Mm          , Mm          
Ms          , Ms          , Ms          , Ms          , Aa^Fpa      , Aa^Fpa      , Aa^Fpa      , Ms          , Ms          , Ms          , Ms          , Ms          , Ms          , Ms          , Ms          , Ms          , Aa          , Ms          , Ms          , Ms          , Ha          , Ha^Vca      , Ha          , Ha          , Ms          , Ms          , Ms          , Ms          , Ms          , Ms          , Ms          , Ms          , Ms          , Ms          , Ms          , Ms          , Ms          , Ms          , Ha          , Mm          , Mm          , Mm          
Mm          , Ms          , Mm          , Aa^Fpa      , Aa^Fpa      , Aa^Fpa      , Aa          , Ha^Vca      , Ha^Fpa      , Ms          , Ai          , Ms          , Ms          , Ms          , Ms          , Aa          , Aa          , Aa          , Aa          , Ha          , Ai          , Ai          , Aa          , Ha          , Ms          , Ms          , Ms          , Ms          , Ha^Vca      , Hh          , Ha^Vca      , Mm          , Mm          , Ms          , Ms          , Ms          , Ms          , Ms          , Ch          , Ha          , Ha          , Mm          
Mm          , Mm          , Gs^Fp       , Aa^Fpa      , Gs^Fp       , Aa^Fpa      , Aa          , Ai          , Ai          , Ai          , Ai          , Ms          , Ai          , Ms          , Ms          , Ms          , Ms          , Aa          , Ai          , Ai          , Ai          , Aa          , Aa          , Aa          , Ms          , Ms          , Ms          , Ai          , Ai          , Ai          , Ha^Fpa      , Mm          , Aa^Fpa      , Ms          , Ms          , Mm          , Mm          , Ha          , 4 Kh        , Ch          , Ha          , Ha          
Mm          , Mm          , Gs^Fp       , Gs^Fp       , Gs^Fp       , Aa^Fpa      , Ha^Fpa      , Ha^Vca      , Ww          , Ww          , Ai          , Ai          , Chr         , Ha          , Ha          , Ha          , Ha          , Ai          , Ai          , Ai          , Ai          , Ww          , Ms          , Ms          , Ms          , Ms          , Ai          , Ai          , Ww          , Ai          , Ha^Fpa      , Ha^Fpa      , Ha^Fpa      , Aa^Fpa      , Aa^Fpa      , Ms          , Mm          , Ha          , Ha          , Ch          , Ha          , Ha          
Mm          , Gs^Fp       , Gs^Fp       , Gs^Fp       , Hh          , Ha^Fpa      , Ha^Fpa      , Ai          , Ww          , Ww          , Hh          , Chr         , 2 Khr       , Chr         , Ha          , Ha          , Mm          , Ai          , Mm          , Ai          , Mm          , Ai          , Ai          , Ms          , Ai          , Ai          , Ww          , Mm          , Ha^Fpa      , Ha^Fpa      , Ha^Fpa      , Ha^Fpa      , Aa^Fpa      , Aa^Fpa      , Aa^Fpa      , Aa^Fpa      , Ha          , Ha          , Ch          , Ch          , Ha          , Ha          
Mm          , Mm          , Hh          , Hh          , Ms          , Ha^Fpa      , Ha^Fpa      , Ww          , Ai          , Ai          , Ha^Vca      , Chr         , Chr         , Chr         , Ha          , Ha          , Ms          , Ms          , Mm          , Ha          , Ha          , Ha          , Mm          , Ai          , Ms          , Ha          , Ha          , Mm          , Mm          , Mm          , Ha^Fpa      , Aa^Fpa      , Aa^Fpa      , Aa^Fpa      , Ha^Fpa      , Ha^Fpa      , Ha^Vca      , Ha          , Ha          , Ha          , Mm          , Mm          
Ms          , Hh          , Ms^Vhha     , Ms          , Ms          , Ha^Fpa      , Ha^Fpa      , Mm          , Hh          , Ha          , Ha          , Ha          , Ha          , Ha          , Ms          , Ms          , Ms          , Ms          , Ms          , Mm          , Mm          , Hh          , Hh          , Ww          , Ms          , Ha          , Mm          , Mm          , Mm          , Mm          , Mm          , Ha^Fpa      , Ha^Fpa      , Ha^Fpa      , Ha^Fpa      , Mm          , Mm          , Mm          , Mm          , Mm          , Mm          , Mm          
Ms          , Ms          , Ms          , Ms          , Ms          , Ms          , Mm          , Mm          , Hh          , Ha          , Hh          , Ha^Vca      , Mm          , Ms          , Ms          , Ms          , Ms          , Ms          , Mm          , Mm          , Hh          , Hh          , Mm          , Ww          , Ai          , Ha          , Mm          , Mm          , Ms          , Ha^Fpa      , Ha^Fpa      , Ha^Fpa      , Ha^Fpa      , Ha^Fpa      , Hh^Fp       , Mm          , Mm          , Ms          , Ms          , Ms          , Ms          , Ms          
Ms          , Ms          , Ms          , Ms          , Ha          , Ms          , Mm          , Mm          , Hh          , Ha          , Ha          , Mm          , Mm          , Ms          , Ms          , Ms          , Ms          , Ms          , Mm          , Ha          , Ha          , Mm          , Ww          , Ww          , Ai          , Ha          , Ms          , Ms          , Ms          , Ms          , Ms          , Mm          , Mm          , Mm          , Mm          , Mm          , Ms          , Ms          , Ms          , Ms          , Ms          , Mm          
Ms          , Ms          , Ms          , Ms          , Ha          , Ha          , Ha          , Ha          , Ha          , Mm          , Ha          , Mm          , Mm          , Ms          , Ms          , Mm          , Ms          , Mm          , Mm          , Ha          , Ha          , Ai          , Ww          , Ai          , Aa          , Ms          , Ms          , Mm          , Ms          , Ms          , Ms          , Mm          , Ms          , Mm          , Mm          , Ms          , Mm          , Ms          , Ms          , Ms          , Ms          , Mm          
Ms          , Ms          , Ms          , Mm          , Ha          , Ha          , Hh          , Ha          , Ha          , Ha          , Ha          , Ha          , Ha          , Mm          , Mm          , Ms          , Mm          , Mm          , Mm          , Ha          , Ai          , Ww          , Ha          , Aa          , Aa          , Ms          , Ms          , Ms          , Ms          , Ms          , Ms          , Ms          , Ms          , Ms          , Ms          , Ms          , Mm          , Ms          , Ms          , Ms          , Ms          , Mm          
Ms          , Ms          , Ms          , Ms^Vhha     , Ha          , Ha          , Ha          , Ha          , Ha          , Ha          , Ha          , Mm          , Mm          , Mm          , Mm          , Mm          , Mm          , Mm          , Hh          , Ha          , Ww          , Ww          , Aa          , Ha          , Ha          , Mm          , Ms          , Ms          , Ms          , Ms          , Ms          , Ms          , Ms          , Ms          , Ms          , Ms          , Ms          , Ms          , Ms          , Ms          , Ms          , Mm          
Mm          , Ms          , Hh          , Hh          , Mm          , Hh          , Ha          , Ha          , Ha          , Ha          , Ha          , Mm          , Mm          , Mm          , Mm          , Mm          , Mm          , Hh          , Mm          , Ha          , Ww          , Ww          , Ha          , Ha          , Ms          , Mm          , Ms          , Ms          , Ms          , Ms          , Mm          , Ms          , Ms          , Ms          , Mm          , Ms          , Mm          , Mm          , Mm          , Mm          , Ms          , Ms          
Mm          , Ms          , Ms          , Mm          , Mm          , Mm          , Hh          , Hh          , Hh          , Ha          , Mm          , Mm          , Mm          , Mm          , Mm          , Hh          , Hh          , Hh          , Mm          , Ww          , Mm          , Mm          , Mm          , Ha          , Ms          , Ms          , Ms          , Ms          , Hh^Fp       , Mm          , Mm          , Mm          , Mm          , Ms          , Ms          , Ms          , Mm          , Mm          , Ms          , Ms          , Ms          , Ms          
Ms          , Ms          , Ms          , Hh          , Hh          , Hh          , Hh          , Mm          , Hh          , Ha          , Mm          , Mm          , Hh          , Mm          , Hh          , Hh          , Mm          , Mm          , Ww          , Ww          , Mm          , Mm          , Mm          , Mm          , Mm          , Ms          , Ms          , Hh^Fp       , Mm          , Hh^Fp       , Hh^Fp       , Mm          , Mm          , Mm          , Mm          , Ms          , Ms          , Ms          , Ms          , Ms          , Ms          , Mm          
Ms          , Ms          , Ms          , Mm          , Mm          , Hh          , Mm          , Mm          , Ms          , Mm          , Ms          , Mm          , Ms          , Ms          , Ms          , Hh          , Ai          , Mm          , Ww          , Ww          , Mm          , Mm          , Mm          , Mm          , Mm          , Mm          , Mm          , Hh^Fp       , Hh^Fp       , Mm          , Hh^Fp       , Hh^Fp       , Mm          , Mm          , Mm          , Ms          , Ms          , Ms          , Ms          , Ms          , Ms          , Mm          
Ms          , Ms          , Ms          , Ms          , Ms          , Mm          , Ms          , Ms          , Ms          , Ms          , Ms          , Ms          , Ms          , Ms          , Mm          , Mm          , Ai          , Ai          , Wo          , Ai          , Ai          , Mm          , Mm          , Mm          , Mm          , Mm          , Mm          , Hh^Fp       , Hh^Fp       , Hh^Fp       , Mm          , Hh^Fp       , Hh^Fp       , Hh^Fp       , Mm          , Mm          , Ms          , Mm          , Ms          , Ms          , Mm          , Mm          
Ms          , Ms          , Hh          , Ms          , Ms          , Mm          , Ms          , Ms          , Ms          , Ms          , Ms          , Ms          , Ms          , Ms          , Mm          , Ai          , Ai          , Wo          , Wo          , Ai          , Ai          , Ai          , Mm          , Mm          , Aa          , Mm          , Aa          , Mm          , Aa          , Hh^Fp       , Mm          , Mm          , Mm          , Mm          , Mm          , Mm          , Ms          , Ms          , Ms          , Ms          , Mm          , Mm          
Hh          , Hh          , Mm          , Hh          , Ha          , Ms^Vhha     , Ha          , Ms          , Mm          , Ms          , Ms          , Ms          , Ms          , Ms          , Mm          , Ai          , Wo          , Wo          , Wo          , Wo          , Ai          , Ai          , Aa          , Aa          , Aa          , Aa          , Aa          , Aa          , Aa^Fpa      , Hh^Fp       , Hh^Fp       , Mm          , Mm          , Mm          , Mm          , Mm          , Mm          , Ms          , Ms          , Mm          , Mm          , Mm          
Mm          , Hh          , Mm          , Ms^Vhha     , Mm          , Ha          , Mm          , Mm          , Ha          , Hh          , Mm          , Ms^Vhha     , Ms          , Ms          , Ai          , Ai          , Wo          , Wo          , Ai          , Ai          , Ai          , Aa          , Aa          , Mm          , Ha          , Ms^Vhha     , Aa^Fpa      , Aa^Fpa      , Aa^Fpa      , Aa^Fpa      , Mm          , Hh^Fp       , Hh^Fp       , Mm          , Hh^Fp       , Mm          , Mm          , Mm          , Ms          , Ms          , Mm          , Mm          
Mm          , Hh          , Hh          , Mm          , Ha          , Ha          , Mm          , Hh          , Hh          , Hh          , Mm          , Ms          , Ms          , Ww          , Ms          , Ai          , Ai          , Ai          , Ai          , Ai          , Aa^Voa      , Ha          , Ha          , Ha          , Ha          , Ha          , Aa^Fpa      , Aa^Fpa      , Aa^Fpa      , Aa^Fpa      , Mm          , Mm          , Hh^Fp       , Hh^Fp       , Mm          , Mm          , Ms          , Mm          , Ms          , Ms          , Mm          , Mm          
Ww          , Hh          , Mm          , Ha          , Ha          , Mm          , Mm          , Mm          , Mm          , Mm          , Mm          , Ms          , Ww          , Ww          , Ms          , Hh          , Hh          , Mm          , Ha          , Mm          , Ha          , Ha          , Hh          , Ha          , Ha          , Ha          , Ha          , Mm          , Mm          , Mm          , Mm          , Mm          , Mm          , Mm          , Mm          , Ms          , Ms          , Ms          , Ms          , Mm          , Mm          , Mm          
Mm          , Ww          , Ww          , Ww          , Ww          , Ww          , Ww          , Mm          , Ww          , Mm          , Mm          , Ms          , Mm          , Ww          , Mm          , Hh          , Ms          , Ha          , Ha          , Ha          , Ha          , Ha          , Mm          , Mm          , Mm          , Ha          , Mm          , Mm          , Mm          , Mm          , Mm          , Mm          , Mm          , Mm          , Ms^Vhha     , Ms          , Mm          , Ms          , Mm          , Mm          , Mm          , Mm          
Mm          , Mm          , Ha          , Ww          , Ha          , Ha          , Mm          , Ww          , Mm          , Ww          , Ww          , Ww          , Ww          , Ww          , Ms          , Ms          , Ms          , Ms          , Ms          , Ha          , Mm          , Mm          , Mm          , Mm          , Mm          , Mm          , Mm          , Mm          , Mm          , Mm          , Ms          , Mm          , Ms          , Ms          , Ms          , Ms          , Ms          , Mm          , Ms          , Mm          , Mm          , Mm          
Hh          , Ha          , Hh          , Ha          , Ha          , Ms^Vhha     , Mm          , Mm          , Mm          , Ww          , Ww          , Ww          , Ww          , Ww          , Ww          , Ms          , Ms          , Ms          , Ha^Voa      , Mm          , Ha          , Mm          , Mm          , Mm          , Ha          , Mm          , Mm          , Mm          , Ms          , Ms          , Ms          , Ms          , Ms          , Ms          , Ms          , Ms          , Ms          , Ms          , Ms          , Ms          , Mm          , Mm          
Mm          , Mm          , Mm          , Mm          , Mm          , Mm          , Mm          , Mm          , Mm          , Ww          , Ai          , Ww          , Ai          , Ww          , Ha          , Ms          , Ms          , Ms          , Ha          , Ha          , Aa          , Ha          , Ha          , Ha          , Ha          , Mm          , Mm          , Mm          , Mm          , Mm          , Mm          , Ms          , Mm          , Ms          , Ms          , Ms          , Ms          , Ms          , Ms          , Ms          , Mm          , Mm          
Xu          , Mm          , Mm          , Mm          , Mm          , Mm          , Mm          , Mm          , Ww          , Ww          , Mm          , Ai          , Ai          , Ha          , Ha          , Ms          , Aa          , Ha          , Aa          , Aa          , Aa          , Aa          , Ha          , Ha          , Mm          , Mm          , Mm          , Mm          , Aa          , Mm          , Aa^Fpa      , Ms          , Ms          , Mm          , Mm          , Ms          , Ms          , Ms          , Ms          , Ms^Vhha     , Mm          , Mm          
Xu          , Xu          , Mm          , Xu          , Xu          , Xu          , Ww          , Ww          , Ww          , Ww          , Mm          , Mm          , Mm          , Ai          , Ai          , Ai          , Aa          , Aa          , Aa          , Ha          , Ha          , Ha          , Ha          , Ha^Voa      , Mm          , Mm          , Aa^Fpa      , Aa          , Aa^Fpa      , Aa^Fpa      , Aa^Fpa      , Mm          , Ha^Fpa      , Aa^Fpa      , Ha^Fpa      , Aa^Fpa      , Ha^Fpa      , Ms          , Ms          , Mm          , Ms          , Mm          
Xu          , Xu          , Uu^Tfi      , Xu          , Ww          , Uu^Tfi      , Ww          , Ww          , Ww          , Mm          , Mm          , Mm          , Ai          , Ai          , Ai          , Ai          , Aa          , Aa          , Aa          , Mm          , Ha          , Mm          , Aa          , Ha          , Ha^Voa      , Aa^Fpa      , Aa^Fpa      , Aa          , Mm          , Aa^Fpa      , Ha^Fpa      , Ha^Fpa      , Mm          , Ha^Fpa      , Ha^Fpa      , Ha^Fpa      , Ha^Fpa      , Ha^Fpa      , Mm          , Ms          , Ms          , Ms          
Xu          , Uu^Tfi      , Ww          , Ww          , Chw         , Ww          , Chw         , Ww          , Ww          , Xu          , Mm          , Mm          , Mm          , Ai          , Ai          , Ha^Voa      , Aa          , Ha          , Mm          , Ha          , Ha          , Aa          , Aa          , Ha          , Aa^Fpa      , Aa^Fpa      , Aa^Fpa      , Aa^Fpa      , Aa^Fpa      , Mm          , Mm          , Ha^Fpa      , Ha^Fpa      , Ha^Fpa      , Ha^Fpa      , Ha^Fpa      , Ha^Fpa      , Mm          , Mm          , Ms          , Mm          , Ms          
Ww          , Ww          , Ww          , Ww          , Chw         , Chw         , Khw         , Chw         , Xu          , Xu          , Mm          , Mm          , Mm          , Mm          , Ha          , Ha          , Ha          , Ha          , Mm          , Ha          , Ha^Voa      , Ha          , Aa^Fpa      , Aa^Fpa      , Co          , Co          , 3 Ko        , Co          , Co          , Mm          , Ha^Voa      , Mm          , Mm          , Mm          , Mm          , Mm          , Mm          , Mm          , Mm          , Mm          , Mm          , Mm          
Wo          , Ww          , Wo          , Ww          , Chw         , Uu^Tfi      , Xu          , Xu          , Xu          , Xu          , Mm          , Mm          , Mm          , Mm          , Ha          , Mm          , Hh          , Mm          , Mm          , Ha          , Ha          , Ha          , Ha          , Aa^Fpa      , Aa^Fpa      , Co          , Aa^Fpa      , Co          , Aa          , Aa          , Mm          , Mm          , Mm          , Mm          , Mm          , Mm          , Mm          , Mm          , Mm          , Mm          , Mm          , Mm          
Wo          , 1 Wo        , Ww          , Ww          , Xu          , Uu^Tfi      , Xu          , Mm          , Mm          , Mm          , Mm          , Mm          , Mm          , Mm          , Ha          , Mm          , Hh          , Mm          , Mm          , Mm          , Mm          , Mm          , Mm          , Mm          , Aa^Fpa      , Aa^Fpa      , Aa^Fpa      , Aa^Fpa      , Aa          , Mm          , Mm          , Mm          , Mm          , Mm          , Mm          , Mm          , Mm          , Mm          , Mm          , Mm          , Mm          , Mm          
Wo          , Wo          , Xu          , Xu          , Xu          , Xu          , Xu          , Xu          , Xu          , Mm          , Mm          , Mm          , Mm          , Mm          , Mm          , Ha          , Ha          , Ha          , Ha          , Mm          , Mm          , Mm          , Aa^Fpa      , Aa^Fpa      , Aa^Fpa      , Aa^Fpa      , Aa^Fpa      , Ha^Voa      , Mm          , Mm          , Mm          , Mm          , Mm          , Mm          , Mm          , Mm          , Mm          , Mm          , Mm          , Mm          , Mm          , Mm          
