border_size=1
usage=map

Ww          , Ww          , Ww          , Xu          , Xu          , Xu          , Xu          , Xu          , Xu          , Xu          , Xu          , Xu          , Xu          , Xu          , Xu          , Xu          , Ql          , Ql          , Ql          , Ql          , Ql          , Ql          , Ql          , Ql          
Ww          , Wo          , 4 Wo        , Wo          , Uu^Vu       , Xu          , Xu          , Xu          , Xu          , Xu          , 3 Xu        , Xu          , Xu          , Xu          , Xu          , Xu          , Ql          , Ql          , Ql          , Ql          , 6 Ql        , Ql          , Uu^Vu       , Ql          
Xu          , Wo          , Wo          , Wo          , Uu^Uf       , Uu^Uf       , Xu          , Xu          , Xu          , Xu          , Xu          , Xu          , Xu          , Xu          , Ql          , Ql          , Ql          , Ql          , Ql          , Ql          , Ql          , Ql          , Ql          , Ql          
Qxu         , Ww          , Uu^Uf       , Ww          , Ww          , Uu^Uf       , Uu^Uf       , Xu          , Xu          , Xu          , Xu          , Xu          , Xu          , Xu          , Ql          , Ql          , Ql          , Ql          , Ql          , Ql          , Xu          , Ql          , Ql          , Ql          
Qxu         , Qxu         , Qxu         , Uu^Uf       , Uu^Uf       , Ww          , Ww^Ii       , Ur          , Xu          , Xu          , Xu          , Xu          , Xu          , Xu          , Ql          , Ql          , Ql          , Ql          , Ql          , Xu          , Xu          , Uu^Vu       , Xu          , Xu          
Qxu         , Qxu         , Qxu         , Qxu         , Qxu         , Uu^Uf       , Ww^Ii       , Uu^Ufi      , Uu^Ufi      , Uh          , Uh          , Xu          , Xu          , Xu          , Ql          , Ql          , Ql          , Xu          , Xu          , Xu          , Xu          , Xu          , Xu          , Xu          
Qxu         , 5 Qxu       , Qxu         , Qxu         , Qxu         , Qxu         , Xu          , Uu^Ufi      , Uu          , Uu          , Uu          , Uh          , Uh          , Ql          , Ql          , Ql          , Xu          , Xu          , Xu          , Xu          , Xu          , Xu          , Xu          , Xu          
Xu          , Qxu         , Uh          , Qxu         , Uh          , Qxu         , Xu          , Uu^Ii       , Uu          , Uu          , Uu          , Uu          , Uh          , Uh          , Uh          , Uh          , Xu          , Xu          , Uh          , Xu          , Xu          , Xu          , Xu          , Xu          
Xu          , Xu          , Uh          , Uh          , Uh          , Uh          , Uh          , Uu^Vu       , Uh          , Uu          , Uu          , Ur          , Ur          , Uh          , Uh          , Uh          , Uu^Vu       , Uh          , Uh          , Uh          , Uh          , 7 Uh        , Uh          , Xu          
Xu          , Xu          , Xu          , Uh          , Uh          , Uh          , Uh          , Uh          , Uh          , Uh          , Uu^Vu       , Xu          , Uh          , Ur          , Ur          , Ur          , Uh          , Uu          , Uu          , Uu          , Uu          , Uh          , Uu          , Xu          
Xu          , Xu          , Xu          , Xu          , Xu          , Uh          , Uh          , Uh          , Xu          , Xu          , Xu          , Xu          , Xu          , Xu          , Xu          , Xu          , Uu^Vu       , Uh          , Uh          , Uu          , Uu          , Uu          , Uu          , Xu          
Xu          , Uu^Vu       , Qlf         , Xu          , Xu          , Xu          , Xu          , Xu          , Xu          , Xu          , Xu          , Xu          , Xu          , Xu          , Xu          , Xu          , Ur          , Ur          , Xu          , Xu          , Xu          , Xu          , Uu          , Xu          
Qlf         , Qlf         , Qlf         , Qlf         , Qlf         , Qlf         , Qlf         , Qlf         , Qlf         , Qlf         , Qlf         , Xu          , Qlf         , Xu          , Xu          , Xu          , Ur          , Ur          , Xu          , Xu          , Uu          , Uu^Vu       , Uu          , Xu          
Xu          , Xu          , Xu          , Qlf         , Xu          , Qlf         , Xu          , Qlf         , Xu          , Qlf         , Qlf         , Qlf         , Qlf         , Qlf         , Qlf         , Qlf         , Ur          , Ur          , Ur          , Uu          , Uu          , Uu          , Uu          , Xu          
Xu          , Xu          , Xu          , Xu          , Xu          , Xu          , Xu          , Xu          , Xu          , Xu          , Xu          , Qlf         , Qlf         , Qlf         , Qlf         , Qlf         , Ur          , Ur          , Qlf         , Uu          , Uu          , Uu          , Uu          , Xu          
Xu          , Xu          , Xu          , Xu          , Xu          , Xu          , Xu          , Xu          , Xu          , Xu          , Xu          , Xu          , Xu          , Qlf         , Uu          , Xu          , Ur          , Qlf         , Qlf         , Uu          , Uu          , Uu          , Xu          , Xu          
Qxu         , Qxu         , Qxu         , Uu^Vu       , Qxu         , Qxu         , Qxu         , Qxu         , Qxu         , Qxu         , Qxu         , Xu          , Xu          , Xu          , Uu^Vu       , Uu          , Ur          , Qlf         , Qlf         , Xu          , Xu          , Xu          , Qlf         , Xu          
Xu          , Qxu         , Qxu         , Qxu         , Qxu         , Qxu         , Qxu         , Qxu         , Xu          , Qxu         , Qxu         , Qxu         , Qxu         , Xu          , Ur          , Ur          , Ur          , Qlf         , Qlf         , Qlf         , Qlf         , Qlf         , Qlf         , Qlf         
Xu          , Xu          , Xu          , Xu          , Xu          , Xu          , Xu          , Xu          , Xu          , Xu          , Xu          , Qxu         , Qxu         , Qxu         , Qxu         , Ur          , Xu          , Xu          , Xu          , Qlf         , Qlf         , Qlf         , Qlf         , Qlf         
Xu          , Xu          , Xu          , Xu          , Xu          , Xu          , Xu          , Xu          , Xu          , Xu          , Uu          , Uu          , Ur          , Qxu         , Qxu         , Qxu         , Qxu         , Qxu         , Qxu         , Xu          , Qxu         , Qlf         , Qlf         , Qlf         
Ww          , Xu          , Xu          , Xu          , Xu          , Xu          , Xu          , Xu          , Xu          , Xu          , Ur          , Ur          , Uu          , Uu          , Xu          , Xu          , Xu          , Qxu         , Qxu         , Qxu         , Qxu         , Qxu         , Qxu         , Qlf         
Ww          , Ww          , Ww          , Xu          , Xu          , Xu          , Xu          , Xu          , Uu          , Ur          , Ur          , Ur          , Ur          , Xu          , Xu          , Xu          , Qxu         , Qxu         , Qxu         , Qxu         , Qxu         , Qxu         , Qxu         , Xu          
Ww          , Ww          , Ww          , Ww          , Ww          , Ww          , Ww          , Xu          , Xu          , Uu          , Uu^Uf       , Uu^Vu       , Uu^Uf       , Ur          , Uu          , Xu          , Xu          , Qxu         , Qxu         , Qxu         , Qxu         , Qxu         , Qxu         , Xu          
Xu          , Ww          , Ww          , Ww          , Ww          , Ww          , Ww          , Ww          , Ww          , Uu^Uf       , Ww          , Uu^Uf       , Uu^Uf       , Uu^Uf       , Uu^Uf       , Xu          , Xu          , Xu          , Xu          , Qxu         , Qxu         , Qxu         , Qxu         , Xu          
Xu          , Xu          , Xu          , Ww          , Ww          , Ww          , Ww          , Ww          , Ww          , Ww          , Ww          , Ww          , Ww          , Ur          , Ur          , Xu          , Qxu         , Qxu         , Qxu         , Qxu         , Qxu         , Qxu         , Qxu         , Qxu         
Xu          , Xu          , Xu          , Xu          , Xu          , Xu          , Xu          , Ww          , Ww          , Ww          , Ww          , Ww          , Ww          , Ww          , Ww          , Xu          , Qxu         , Qxu         , Qxu         , Qxu         , Qxu         , Qxu         , Qxu         , Qxu         
Xu          , Xu          , Xu          , Xu          , Xu          , Xu          , Xu          , Xu          , Xu          , Xu          , Xu          , Ww          , Ww          , Ww          , Ww          , Ww          , Ww          , Qxu         , Uu          , Qxu         , Qxu         , Qxu         , Qxu         , Qxu         
Xu          , Xu          , Xu          , Xu          , Xu          , Xu          , Xu          , Xu          , Xu          , Xu          , Xu          , Xu          , Qxu         , Ww          , Ww          , Ww          , Ww          , Ww          , Uu^Uf       , Uu^Vu       , Qxu         , Qxu         , Qxu         , Qxu         
Xu          , Qxu         , Qxu         , Xu          , Qxu         , Xu          , Xu          , Xu          , Xu          , Xu          , Qxu         , Qxu         , Qxu         , Ww          , Ww          , Ww          , Ww          , Ww          , Uu^Uf       , Qxu         , Qxu         , Qxu         , Qxu         , Qxu         
Xu          , Qxu         , Qxu         , Qxu         , Qxu         , Qxu         , Qxu         , Qxu         , Qxu         , Qxu         , Qxu         , Qxu         , Wwf         , Ww          , Wwf         , Ww          , Wwf         , Wwf         , Uu^Uf       , Qxu         , Qxu         , Qxu         , Qxu         , Qxu         
Xu          , Qxu         , Qxu         , Qxu         , Xu          , Qxu         , Qxu         , Qxu         , Qxu         , Qxu         , Qxu         , Qxu         , Uu^Uf       , Wwf         , Uu^Uf       , Wwf         , Uu^Uf       , Uu^Uf       , Uu^Uf       , Qxu         , Qxu         , Qxu         , Qxu         , Qxu         
Xu          , Xu          , Xu          , Xu          , Xu          , Xu          , Xu          , Xu          , Xu          , Qxu         , Qxu         , Qxu         , Uu          , Uu^Uf       , Uu^Uf       , Uu          , Uu          , Uu^Vu       , Uu^Uf       , Qxu         , Qxu         , Qxu         , Qxu         , Qxu         
Xu          , Xu          , Xu          , Xu          , Xu          , Xu          , Re          , Re          , Uu          , Uu          , Uu          , Qxu         , Qxu         , Uu          , Uu          , Uu^Uf       , Ur          , Uu^Uf       , Ur          , Uu          , Uu          , Qxu         , Qxu         , Qxu         
Xu          , Xu          , Xu          , Xu          , Re          , Re          , Re          , Re          , Re          , Uu          , Ur          , Uu          , Ur          , Uu          , Ur          , Ur          , Ur          , Ur          , Ur          , Uu          , Uh          , Uh          , Qxu         , Qxu         
Xu          , Xu          , Xu          , Ur          , Xu          , Re          , Re          , Re          , Re          , Uu          , Xu          , Ur          , Xu          , Ur          , Uu^Vu       , Ur          , Ur          , Ur          , Uu          , Uh          , Uh          , Uh          , Uh          , Qxu         
Xu          , Xu          , 1 Ur^Ii     , Ur^Ii       , Xu          , Re          , Re          , Re          , Xu          , Xu          , Xu          , Xu          , Xu          , Xu          , Xu          , Uu          , Uh          , Uh          , Uh          , Uh          , Uh          , Uh          , Uh          , Xu          
Xu          , Ur          , Xu          , Xu          , Xu          , Xu          , Xu          , Xu          , Xu          , Xu          , Xu          , Xu          , Xu          , Xu          , Xu          , Uh          , Uh          , Uh          , Uh          , Uh          , Uh          , Uh          , Uh          , Xu          
