border_size=1
usage=map

Xu          , Xu          , Xu          , Xu          , Xu          , Ql          , Ql          , Xu          , Xu          , Xu          , Xu          , Ql          , Ql          , Ql          , Ql          , Ql          , Ql          , Ql          , Ur          , Ql          , Ql          , Ql          , Ql          , Ql          , Ql          , Xu          , Xu          , Xu          , Xu          , Xu          , Xu          , Xu          , Xu          , Xu          
Ql          , Ql          , Xu          , Ql          , Xu          , Ql          , Ql          , Ql          , Ql          , Ql          , Ql          , Ql          , Ql          , Ql          , Ql          , Ql          , Xos         , Ur          , Ur          , Ur          , Xos         , Ql          , Ql          , Ql          , Ql          , Ql          , Ql          , Xu          , Ql          , Xu          , Xu          , Xu          , Ql          , Xu          
Ql          , Ql          , Ql          , Ql          , Ql          , Xu          , Ql          , Xu          , Xu          , Ql          , Ql          , Ql          , Ql          , Ql          , Xos         , Xos         , Ql          , Ql          , Ur^Ii       , Ql          , Ql          , Xos         , Xos         , Ql          , Ql          , Xu          , Ql          , Ql          , Xu          , Ql          , Ql          , Ql          , Ql          , Xu          
Ql          , Ql          , Ql          , Ql          , Ql          , Ql          , Ql          , Ql          , Ql          , Ql          , Ql          , Ql          , Ql          , Ql          , Ql          , Ur          , Ur          , Ur          , Ql          , Ur          , Ur          , Ur          , Ql          , Ql          , Ql          , Ql          , Ql          , Ql          , Xu          , Ql          , Ql          , Xu          , Ql          , Ql          
Xu          , Ql          , Ql          , Ql          , Ql          , Ql          , Ql          , Ql          , Ql          , Ql          , Ql          , Ql          , Ql          , Ql          , Ql          , Ql          , Ql          , Ur          , Ur          , Ur          , Ql          , Ql          , Ql          , Ql          , Ql          , Ql          , Ql          , Ql          , Ql          , Xu          , Ql          , Ql          , Ql          , Ql          
Xu          , Ql          , Ql          , Ql          , Ql          , Ql          , Ql          , Ql          , Xu          , Ql          , Ql          , Ql          , Xu          , Ql          , Ql          , Ql          , Ql          , Ql          , Ql^Bs|      , Ql          , Ql          , Ql          , Ql          , Ql          , Ql          , Ql          , Ql          , Ql          , Ql          , Ql          , Ql          , Ql          , Ql          , Xu          
Xu          , Xu          , Ql          , Xu          , Ql          , Xu          , Ql          , Xu          , Ql          , Ql          , Xu          , Xu          , Xu          , Xu          , Ql          , Ql          , Ql          , Ql          , Xu          , Ql          , Ql          , Ql          , Xu          , Ql          , Ql          , Ql          , Xu          , Ql          , Ql          , Ql          , Ql          , Ql          , Ql          , Xu          
Ql          , Ql          , Xu          , Ql          , Xu          , Ql          , Ql          , Ql          , Xu          , Xu          , Xu          , Xu          , Xu          , Xu          , Xu          , Xu          , Xu          , Xu          , Uh          , Xu          , Xu          , Xu          , Xu          , Xu          , Xu          , Xu          , Xu          , Xu          , Ql          , Ql          , Xu          , Ql          , Xu          , Xu          
Xu          , Xu          , Xu          , Xu          , Xu          , Xu          , Xu          , Xu          , Xu          , Xu          , Xu          , Uu^Vud      , Cud         , Xu          , Cud         , Uu^Vud      , Cud         , Xu          , Cud         , Xu          , Xu          , Xu          , Xu          , Xu          , Xu          , Xu          , Xu          , Xu          , Ql          , Xu          , Xu          , Xu          , Uu^Vu       , Xu          
Xu          , Xu          , Xu          , Xu          , Xu          , Xu          , Xu          , Xu          , Xu          , Xu          , Xu          , Ur          , Ur          , Cud         , Uu^Vud      , Ur          , Uu^Vud      , Cud         , Ur          , Xu          , Xu          , Xu          , Xu          , Xu          , Xu          , Xu          , Xu          , Xu          , Ql          , Xu          , Xu          , Xu          , Ur          , Ur          
Xu          , Xu          , Xu          , Xu          , Xu          , Xu          , Xu          , Xu          , Xu          , Xu          , Cud         , Uu^Vud      , Ur          , Ur          , Cud         , Cud         , Cud         , Ur          , Ur          , Uu^Vud      , Cud         , Xu          , Ur          , Ur          , Ur          , Xu          , Ur          , Xu          , Xu          , Ql          , Ql^Bs/      , Uu          , Uu^Vu       , Xu          
Xu          , Xu          , Xu          , Xu          , Xu          , Xu          , Ur          , Uu^Vu       , Ur          , Ur          , Ur          , Ur          , Ur          , Ur          , Cud         , 3 Kud       , Cud         , Ur          , Ur          , Ur          , Ur          , Ur          , Uu          , Xu          , Xu          , Ur          , Xu          , Ur          , Ur          , Ur          , Ql          , Xu          , Xu          , Xu          
Xu          , Xu          , Xu          , Xu          , Ur          , Ur          , Uu^Vu       , Ur          , Xu          , Xu          , Cud         , Uu^Vud      , Ur          , Ur          , Uu^Vud      , Cud         , Uu^Vud      , Ur          , Ur          , Ur          , Uu          , Uu^Vu       , Uu          , Xu          , Xu          , Xu          , Xu          , Uu          , Xu          , Xu          , Ql          , Xu          , Xu          , Xu          
Ur          , Xu          , Ur          , Ur          , Xu          , Xu          , Xu          , Xu          , Xu          , Xu          , Xu          , Ur          , Cud         , Cud         , Cud         , Ur          , Cud         , Cud         , Cud         , Uu^Vud      , Cud         , Uu          , Uu          , Xu          , Xu          , Xu          , Xu          , Uu          , Xu          , Xu          , Xu          , Ql          , Ql          , Xu          
Xu          , Ur          , Xu          , Xu          , Xu          , Xu          , Xu          , Xu          , Xu          , Xu          , Xu          , Ur          , Xu          , Xu          , Ur          , Uu^Vud      , Ur          , Xu          , Xu          , Xu          , Xu          , Uu          , Uu^Vu       , Uu          , Uu          , Uu          , Uu^Vu       , Uu          , Xu          , Xu          , Xu          , Xu          , Xu          , Ql          
Xu          , Xu          , Xu          , Xu          , Xu          , Xu          , Xu          , Xu          , Xu          , Xu          , Xu          , Xu          , Xu          , Xu          , Ur          , Xu          , Ur          , Xu          , Xu          , Xu          , Xu          , Uu          , Uu          , Xu          , Xu          , Xu          , Xu          , Uu          , Xu          , Xu          , Xu          , Xu          , Xu          , Xu          
Xu          , Xu          , Xu          , Xu          , Xu          , Xu          , Xu          , Xu          , Xu          , Xu          , Xu          , Xu          , Xu          , Xu          , Cud         , Ur          , Cud         , Xu          , Xu          , Xu          , Xu          , Uu          , Uu          , Xu          , Xu          , Xu          , Xu          , Uu          , Uu          , Xu          , Xu          , Xu          , Xu          , Xu          
Xu          , Xu          , Xu          , Xu          , Xu          , Xu          , Xu          , Xu          , Xu          , Xu          , Xu          , Xu          , Xu          , Xu          , Xu          , Ur          , Ur          , Xu          , Xu          , Xu          , Uu          , Uu          , Uu          , Xu          , Xu          , Xu          , Xu          , Xu          , Xu          , Uu          , Uu          , Xu          , Uu^Vu       , Xu          
Ww          , Xu          , Ww          , Ww          , Ww          , Ww          , Ww          , Xu          , Xu          , Xu          , Xu          , Xu          , Xu          , Xu          , Xu          , Ur          , Ur          , Uu          , Uu          , Uu^Vu       , Xu          , Uu          , Uu          , Xu          , Xu          , Xu          , Xu          , Xu          , Uu          , Uu^Vu       , Ur          , Ur          , Ur          , Ur          
Xu          , Ww          , Xu          , Xu          , Xu          , Ww          , Xu          , Ww          , Wwf         , Ww          , Ww          , Xu          , Uu^Uf       , Xu          , Xu          , Xu          , Ur          , Ur          , Ur          , Xu          , Xu          , Xu          , Ur          , Xu          , Xu          , Xu          , Ur          , Ur          , Ur          , Ur          , Uu          , Uu          , Xu          , Xu          
Xu          , Xu          , Xu          , Xu          , Uu^Vu       , Xu          , Xu          , Wwf         , Xu          , Xu          , Ww          , Uu^Uf       , Ww          , Uu^Uf       , Ur          , Ur          , Re          , Uu          , Xu          , Ur          , Ur          , Ur          , Xu          , Ur          , Ur          , Ur          , Uu          , Uu          , Uu          , Uu          , Xu          , Uu          , Xu          , Xu          
Xu          , Xu          , Xu          , Uh          , Uh          , Xu          , Xu          , Uu^Vu       , Uh          , Xu          , Xu          , Ww          , Ww          , Uu^Uf       , Wwf         , Re          , Xu          , Xu          , Xu          , Xu          , Xu          , Xu          , Xu          , Xu          , Uu          , Uu          , Uu          , Uu          , Uu          , Xu          , Xu          , Xu          , Xu          , Xu          
Xu          , Xu          , Xu          , Uh          , Uh          , Uh          , Uh          , Uh          , Xu          , Uh          , Uh          , Uu          , Ur          , Wwf         , Wwf         , Wwf         , Ww          , Xu          , Xu          , Xu          , Xu          , Xu          , Xu          , Xu          , Uu          , Xu          , Xu          , Xu          , Xu          , Xu          , Xu          , Xu          , Xu          , Xu          
Xu          , Xu          , Xu          , Uh          , Xu          , Uh          , Uh          , Uh          , Uu^Vu       , Uu          , Ur          , Ur          , Uh          , Xu          , Xu          , Ww          , Ww          , Xu          , Xu          , Xu          , Xu          , Uu^Vu       , Uu          , Uu          , Xu          , Xu          , Xu          , Xu          , Xu          , Xu          , Xu          , Xu          , Xu          , Xu          
Xu          , Xu          , Xu          , Uh          , Uh          , Uh          , Uh          , Uu          , Uh          , Uh          , Ur          , Uh          , Uh          , Uu^Vu       , Xu          , Uu^Uf       , Uu^Uf       , Ww          , Ww          , Xu          , Xu          , Uu          , Xu          , Xu          , Xu          , Xu          , Xu          , Xu          , Xu          , Xu          , Xu          , Xu          , Xu          , Xu          
Uu          , Xu          , Xu          , Uu          , Uu          , Uh          , Uu          , Uh          , Xu          , Ur          , Uu          , Uh          , Uh          , Uu          , Uu          , Xu          , Re          , Re          , Wwf         , Xu          , Uu          , Uu          , Xu          , Xu          , Xu          , Xu          , Xu          , Xu          , Xu          , Xu          , Xu          , Xu          , Xu          , Xu          
Xu          , Uu          , Uu          , Uu          , Xu          , Xu          , Xu          , Cud         , Cud         , Ur          , Uh          , Uh          , Uu          , Uu          , Uu          , Uu          , Xu          , Xu          , Wwf         , Re          , Xu          , Uu^Vu       , Xu          , Xu          , Xu          , Xu          , Xu          , Xu          , Xu          , Xu          , Xu          , Xu          , Xu          , Xu          
Xu          , Xu          , Uu^Vu       , Xu          , Xu          , 2 Kud       , Cud         , Uu          , Cud         , Uu^Vu       , Xu          , Uu          , Uu          , Uu          , Uu          , Xu          , Uu^Uf       , Xu          , Wwf         , Xu          , Xu          , Xu          , Xu          , Xu          , Xu          , Xu          , Xu          , Xu          , Xu          , Xu          , Xu          , Xu          , Xu          , Xu          
Ur          , Xu          , Uu          , Xu          , Cud         , Cud         , Uu          , Uu^Vud      , Cud         , Uu          , Uu          , Uu          , Xu          , Uu          , Uu^Vu       , Uu^Uf       , Uu^Uf       , Ww          , Re          , Xu          , Xu          , Xu          , Xu          , Xu          , Xu          , Xu          , Xu          , Xu          , Xu          , Xu          , Xu          , Xu          , Xu          , Xu          
Xu          , Ur          , Ur          , Ur          , Xu          , Uu^Vud      , Cud         , Cud         , Xu          , Uu          , Xu          , Xu          , Xu          , Re          , Ww          , Ww          , Ww          , Ww          , Re          , Xu          , Xu          , Xu          , Xu          , Xu          , Xu          , Xu          , Xu          , Xu          , Xu          , Xu          , Xu          , Xu          , Xu          , Xu          
Xu          , Xu          , Xu          , Xu          , Xu          , Cud         , Xu          , Ur          , Uu          , Uu          , Xu          , Xu          , Uu^Vu       , Re          , Xu          , Ww          , Xu          , Wwf         , Ww          , Xu          , Xu          , Xu          , Wwf         , Xu          , Wwf         , Ww          , Ww          , Ww          , Ww          , Uu^Vu       , Re          , Xu          , Xu          , Xu          
Xu          , Xu          , Xu          , Xu          , Xu          , Uu          , Uu          , Ur          , Uu          , Uu          , Uu          , Uu          , Xu          , Xu          , Xu          , Xu          , Wwf         , Wwf         , Re          , Ww          , Ww          , Wwf         , Ww          , Wwf         , Re          , Ww          , Ww          , Ww          , Ww          , Re          , Re          , Xu          , Xu          , Xu          
Xu          , Xu          , Xu          , Xu          , Xu          , Xu          , Xu          , Ur          , Uu          , Uu          , Xu          , Xu          , Xu          , Xu          , Xu          , Xu          , Ww          , Re          , Re          , Re          , Xu          , Re          , Xu          , Xu          , Xu          , Re          , Re          , Ww          , Ww          , Ww          , Ww          , Ww          , Wwf         , Xu          
Xu          , Xu          , Xu          , Xu          , Xu          , Xu          , Xu          , Ur          , Uu          , Uu^Uf       , Xu          , Xu          , Xu          , Xu          , Re          , Xu          , Wwf         , Ww          , Xu          , Xu          , Xu          , Xu          , Xu          , Xu          , Xu          , Xu          , Xu          , Xu          , Xu          , Xu          , Xu          , Ww          , Wwf         , Wwf         
Xu          , Xu          , Xu          , Xu          , Xu          , Xu          , Xu          , Ur          , Uu          , Uu^Uf       , Uu^Uf       , Xu          , Re          , Re          , Wwf         , Wwf         , Ww          , Xu          , Xu          , Xu          , Xu          , Xu          , Xu          , Xu          , Xu          , Xu          , Xu          , Xu          , Xu          , Xu          , Xu          , Xu          , Xu          , Ww          
Xu          , Xu          , Xu          , Xu          , Xu          , Xu          , Uu^Uf       , Ur          , Uu          , Uu^Uf       , Re          , Ww          , Ww          , Ww          , Xu          , Ww          , Xu          , Xu          , Xu          , Xu          , Xu          , Xu          , Xu          , Xu          , Xu          , Xu          , Xu          , Xu          , Xu          , Xu          , Xu          , Xu          , Xu          , Xu          
Xu          , Xu          , Ur          , Uu^Vu       , Ur          , Xu          , Ur          , Ur          , Wwf         , Wwf         , Ww          , Ww          , Xu          , Xu          , Xu          , Xu          , Xu          , Xu          , Xu          , Xu          , Xu          , Xu          , Xu          , Xu          , Xu          , Xu          , Xu          , Xu          , Xu          , Xu          , Xu          , Xu          , Xu          , Xu          
Ur          , Ur          , Xu          , Ur          , Re          , Ur          , Ww^Bw\      , Ww          , Wwf         , Ww          , Uu          , Xu          , Xu          , Xu          , Xu          , Xu          , Xu          , Xu          , Xu          , Xu          , Xu          , Xu          , Xu          , Xu          , Xu          , Xu          , Xu          , Xu          , Xu          , Xu          , Xu          , Xu          , Xu          , Xu          
Xu          , Xu          , Xu          , Re          , Re          , Re          , Ww          , Ww^Bw\      , Ur          , Uu          , Uu^Vu       , Xu          , Xu          , Xu          , Xu          , Xu          , Xu          , Xu          , Xu          , Xu          , Xu          , Xu          , Xu          , Xu          , Xu          , Xu          , Xu          , Xu          , Xu          , Xu          , Xu          , Xu          , Xu          , Xu          
Xu          , Xu          , Xu          , Xu          , Re          , Ww          , Xu          , Xu          , Xu          , Ur          , Ur          , Uu          , Ur          , Xu          , Uu          , Uu          , Uu          , Xu          , Xu          , Xu          , Xu          , Xu          , Xu          , Xu          , Xu          , Xu          , Xu          , Xu          , Xu          , Xu          , Xu          , Xu          , Uu          , Uu          
Xu          , Xu          , Xu          , Re          , Ww          , Ww          , Xu          , Xu          , Xu          , Xu          , Xu          , Ur          , Xu          , Ur          , Uu          , Xu          , Xu          , Uu          , Uu          , Xu          , Uu          , Uu^Vu       , Uu          , Xu          , Uu          , Xu          , Xu          , Xu          , Xu          , Xu          , Xu          , Xu          , Uu          , Xu          
Xu          , Xu          , Re          , Re          , Ww          , Xu          , Xu          , Xu          , Xu          , Xu          , Xu          , Xu          , Ur          , Ur          , Xu          , Xu          , Xu          , Xu          , Xu          , Uu          , Xu          , Uu          , Xu          , Uu          , Xu          , Uu          , Uu          , Xu          , Xu          , Xu          , Uu          , Uu          , Xu          , Xu          
Re          , Xu          , Re          , Ww          , Ww          , Xu          , Xu          , Xu          , Xu          , Xu          , Ur          , Ur          , Xu          , Uu^Vu       , Xu          , Xu          , Xu          , Xu          , Xu          , Xu          , Xu          , Xu          , Xu          , Uu          , Uu          , Xu          , Uu          , Uu          , Xu          , Uu          , Uu^Vu       , Xu          , Xu          , Xu          
Ww          , Re          , Ww          , Ww          , Xu          , Xu          , Xu          , Xu          , Xu          , Ur          , Uu          , Xu          , Xu          , Xu          , Xu          , Xu          , Xu          , Xu          , Xu          , Xu          , Xu          , Xu          , Xu          , Xu          , Uu          , Uu          , Cud         , Xu          , Uu          , Uu          , Xu          , Xu          , Xu          , Xu          
Ww          , Ww          , Xu          , Ww          , Xu          , Xu          , Xu          , Xu          , Xu          , Ur          , Xu          , Xu          , Xu          , Xu          , Xu          , Xu          , Xu          , Xu          , Xu          , Xu          , Xu          , Xu          , Xu          , Xu          , Xu          , Cud         , 1 Kud       , Cud         , Xu          , Xu          , Xu          , Xu          , Xu          , Xu          
Xu          , Xu          , Xu          , Xu          , Xu          , Xu          , Xu          , Xu          , Xu          , Ur          , Xu          , Xu          , Xu          , Xu          , Xu          , Xu          , Xu          , Xu          , Xu          , Xu          , Xu          , Xu          , Xu          , Xu          , Uu          , Cud         , Cud         , Cud         , Uu          , Xu          , Xu          , Xu          , Xu          , Xu          
Xu          , Xu          , Xu          , Xu          , Xu          , Xu          , Xu          , Xu          , Xu          , Ur          , Xu          , Xu          , Xu          , Xu          , Xu          , Xu          , Xu          , Xu          , Xu          , Xu          , Xu          , Xu          , Xu          , Uu          , Uu          , Uu          , Cud         , Uu          , Uu          , Uu          , Xu          , Xu          , Xu          , Xu          
