border_size=1
usage=map

Ql          , Ql          , Ql          , Ql          , Ql          , Ql          , Ql          , Xu          , Xu          , Xu          , Xu          , Xu          , Xu          , Xu          , Xu          , Xu          , Ur          , Xu          , Xu          , Ql          , Ql          , Ql          , Ql          , Xu          , Xu          , Ql          
Ql          , Ql          , Ql          , Ql          , Ql          , Ql          , Ql          , Xu          , Xu          , Xu          , Xu          , Xu          , Xu          , Xu          , Xu          , Xu          , Ur          , Xu          , Xu          , Xu          , Xu          , Ql          , Ql          , Xu          , Xu          , Ql          
Ql          , Ql          , Ql          , Ql          , Ql          , Ql          , Ql          , Xu          , Xu          , Xu          , Xu          , Xu          , Xu          , Xu          , Xu          , Xu          , Ur          , Uu^Vud      , Xu          , Xu          , Xu          , Ql          , Ql          , Ql          , Xu          , Ql          
Ql          , Ql          , Ql          , Ql          , Ql          , Ql          , Ql          , Ql          , Xu          , Xu          , Xu          , Xu          , Xu          , Xu          , Xu          , Xu          , Xu          , Ur          , Xu          , Xu          , Xu          , Ql          , Ql          , Ql          , Ql          , Ql          
Ql          , Ql          , Xu          , Ql          , Ql          , Ql          , Ql          , Ql          , Ql          , Ql          , Ql          , Xu          , Xu          , Xu          , Xu          , Xu          , Xu          , Ur          , Xu          , Xu          , Xu          , Ql          , Ql          , Ql          , Ql          , Ql          
Uh          , Uh          , 1 Uh        , Xu          , Uh          , Xu          , Xu          , Ql          , Xu          , Ql          , Xu          , Ql          , Xu          , Xu          , Xu          , Xu          , Xu          , Ur          , Uu^Vud      , Xu          , Xu          , Xu          , Ql          , Ql          , Ql          , Xu          
Uh          , Uh          , Uh          , Uh          , Xu          , Xu          , Xu          , Xu          , Xu          , Xu          , Xu          , Ql          , Xu          , Xu          , Cud         , Xu          , Ur          , Ur          , Xu          , Xu          , Xu          , Xu          , Ql          , Ql          , Xu          , Xu          
Xu          , Uh          , Ur          , Uu          , Uu          , Uu          , Uu          , Uu          , Xu          , Xu          , Xu          , Ql          , Ql          , Ql          , Ql^Bs/      , Ur          , Cud         , Xu          , Xu          , Xu          , Xu          , Xu          , Ql          , Ql          , Xu          , Xu          
Ur          , Ur          , Ur          , Ur          , Ur          , Xu          , Xu          , Uu          , Uu          , Xu          , Xu          , Xu          , Cud         , Ur          , Cud         , Ql          , Ql          , Xu          , Xu          , Xu          , Xu          , Ql          , Ql          , Xu          , Xu          , Xu          
Ur          , Xu          , Xu          , Xu          , Xu          , Ur          , Ur          , Ur          , Ur          , Uu          , Xu          , Xu          , Uu          , Ur          , Uu          , Uu          , Ql          , Ql          , Xu          , Xu          , Ql          , Ql          , Ql          , Xu          , Ql          , Xu          
Xu          , Xu          , Uu          , Uu          , Uu          , Uu          , Xu          , Ur          , Xu          , Ur          , Uu          , Uu          , Ur          , Ur          , Ur          , Ur          , Uh          , Ql          , Ql          , Ql          , Ql          , Ql          , Ql          , Ql          , Xu          , Ql          
Uu          , Xu          , Uu          , Uu          , Xu          , Xu          , Cud         , Xu          , Ur          , Ur          , Ur          , Ur          , Xu          , Xu          , Ur          , Uh          , Uh          , Ql          , Ql          , Ql          , Ql          , Ql          , Xu          , Xu          , Xu          , Ql          
Qxu         , Uu          , Qxu         , Xu          , Qxu         , Qxu         , Qxu^Bs/     , Ur          , Cud         , Ur          , Xu          , Uu          , Xu          , Xu          , Xu          , Ur          , Ur          , Ur          , Uu          , Ql          , Ql          , Xu          , Xu          , Xu          , Xu          , Xu          
Qxu         , Qxu         , Qxu         , Qxu         , Qxu         , Uu          , Qxu^Bs\     , Qxu         , Qxu         , Qxu         , Xu          , Uu          , Uu          , Uu          , Uu          , Xu          , Ur          , Ur          , Uu^Vud      , Uu          , Xu          , Xu          , Xu          , Xu          , Xu          , Xu          
Xu          , Xu          , Xu          , Qxu         , Xu          , Qxu         , Qxu^Bs/     , Uu          , Qxu         , Qxu         , Qxu         , Uu          , Xu          , Uu          , Qxu         , Ur          , Cud         , Ur          , Cud         , Uu          , Xu          , Xu          , Xu          , Xu          , Xu          , Xu          
Uu          , Uu^Uf       , Uu^Uf       , Uu^Uf       , Xu          , Uu          , Uu          , Qxu^Bs|     , Qxu         , Qxu         , Qxu         , Qxu         , Qxu         , Qxu         , Qxu         , Qxu         , Cud         , Ur          , Uu          , Uu          , Xu          , Xu          , Xu          , Xu          , Xu          , Xu          
Uu          , Uu          , Uu          , Uu^Uf       , Uu          , Uu          , Xu          , Uu          , Uu          , Uu          , Uh          , Qxu         , Qxu         , Qxu         , Uu          , Uu^Vud      , Cud         , Ur          , Uu          , Uu          , Xu          , Xu          , Xu          , Xu          , Xu          , Xu          
Xu          , Xu          , Xu          , Uu^Vud      , Xu          , Uu          , Xu          , Xu          , Xu          , Uh          , Ur          , Cud         , Cud         , Uu^Vud      , Uu          , Uu          , Ur          , Ur          , Xu          , Xu          , Xu          , Xu          , Xu          , Xu          , Xu          , Xu          
Xu          , Xu          , Xu          , Xu          , Xu          , Uu          , Xu          , Xu          , Uu          , Cud         , Uu          , Ur          , Ur          , Cud         , Ur          , Ur          , Cud         , Uu          , Xu          , Xu          , Xu          , Xu          , Xu          , Xu          , Xu          , Xu          
Qxu         , Xu          , Xu          , Xu          , Xu          , Uu          , Xu          , Xu          , Uu^Vud      , Qxu         , Qxu         , Uu          , Ur          , Ur          , Ur          , Uu          , Uu          , Uu          , Uu^Vud      , Xu          , Xu          , Xu          , Xu          , Xu          , Xu          , Xu          
Qxu         , Qxu         , Qxu         , Qxu         , Qxu^Bs/     , Uu          , Uu          , Xu          , Xu          , Xu          , Xu          , Uu          , Ur          , Uu          , Xu          , Uu          , Uu          , Uu          , Uu^Vud      , Xu          , Xu          , Xu          , Xu          , Xu          , Xu          , Xu          
Xu          , Qxu         , Xu          , Ur          , Qxu         , Qxu         , Qxu         , Uu          , Uu          , Uu^Vud      , Uu          , Xu          , Ur          , Xu          , Xu          , Xu          , Uu^Vud      , Uu          , Xu          , Xu          , Xu          , Xu          , Xu          , Xu          , Xu          , Xu          
Xu          , Xu          , Ur          , Ur          , Xu          , Uh          , Uh          , Xu          , Uu          , Uu          , Uu          , Uu          , Ur          , Xu          , Xu          , Xu          , Xu          , Xu          , Xu          , Xu          , Xu          , Xu          , Xu          , Xu          , Xu          , Xu          
Ur          , Ur          , Ur          , Xu          , Xu          , Xu          , Uh          , Uh          , Uh          , Uu          , Uh          , Ur          , Cud         , Uh          , Xos         , Xu          , Xu          , Xu          , Xu          , Xu          , Xu          , Xu          , Xu          , Xu          , Xu          , Xu          
Xu          , Xu          , Uu^Vu       , Uu          , Uu          , Uh          , Xu          , Uh          , Xu          , Xu          , Cud         , Cud         , Cud         , Xos         , Xos         , Xu          , Xu          , Xu          , Xu          , Xu          , Xu          , Xu          , Xu          , Xu          , Xu          , Xu          
Xu          , Xu          , Xu          , Xu          , Xu          , Uh          , Xu          , Xu          , Xu          , Xu          , Xos         , Xos         , Cud         , Cud         , Cud         , Cud         , Xu          , Xu          , Xu          , Xu          , Xu          , Xu          , Xu          , Xu          , Xu          , Xu          
Xu          , Xu          , Xu          , Xu          , Xu          , Xu          , Xu          , Xu          , Xu          , Xu          , Cud         , Cud         , Cud         , Cud         , Cud         , Cud         , Cud         , Xu          , Xu          , Xu          , Xu          , Xu          , Xu          , Xu          , Xu          , Xu          
Xu          , Xu          , Xu          , Xu          , Xu          , Xu          , Xu          , Xu          , Xu          , Xu          , Cud         , Cud         , Cud         , Cud         , Cud         , Cud         , Xu          , Xu          , Xu          , Xu          , Xu          , Xu          , Xu          , Xu          , Xu          , Xu          
Xu          , Xu          , Xu          , Xu          , Xu          , Xu          , Xu          , Xu          , Xu          , Xu          , Xos         , Cud         , Cud         , Cud         , Cud         , Cud         , Xos         , Xu          , Xu          , Xu          , Xu          , Xu          , Xu          , Xu          , Xu          , Xu          
Xu          , Xu          , Xu          , Xu          , Xu          , Xu          , Xu          , Xu          , Xu          , Uh          , Uh          , Xos         , Cud         , 2 Kud       , Cud         , Xos         , Uh          , Xu          , Xu          , Xu          , Xu          , Xu          , Xu          , Xu          , Xu          , Xu          
Xu          , Xu          , Xu          , Xu          , Xu          , Xu          , Xu          , Xu          , Xu          , Xu          , Uh          , Xos         , Xos         , Cud         , Xos         , Xos         , Uh          , Uh          , Xu          , Xu          , Xu          , Xu          , Xu          , Xu          , Xu          , Xu          
Xu          , Xu          , Xu          , Xu          , Xu          , Xu          , Xu          , Xu          , Uh          , Uh          , Uh          , Uh          , Uh          , Xos         , Uh          , Uh          , Xu          , Xu          , Xu          , Xu          , Xu          , Xu          , Xu          , Xu          , Xu          , Xu          
Xu          , Xu          , Xu          , Xu          , Xu          , Xu          , Xu          , Xu          , Uh          , Xu          , Xu          , Xu          , Uh          , Uh          , Xu          , Uu          , Uh          , Xu          , Xu          , Xu          , Xu          , Xu          , Xu          , Xu          , Xu          , Xu          
Xu          , Xu          , Xu          , Xu          , Xu          , Xu          , Xu          , Xu          , Uh          , Xu          , Xu          , Xu          , Xu          , Uh          , Uh          , Uh          , Uh          , Xu          , Xu          , Xu          , Xu          , Xu          , Xu          , Xu          , Xu          , Xu          
Xu          , Xu          , Xu          , Xu          , Xu          , Xu          , Xu          , Xu          , Xu          , Uh          , Uh          , Xu          , Xu          , Xu          , Uh          , Uh          , Uh          , Xu          , Xu          , Xu          , Xu          , Xu          , Xu          , Xu          , Xu          , Xu          
Xu          , Xu          , Xu          , Xu          , Xu          , Xu          , Xu          , Xu          , Xu          , Xu          , Xu          , Uh          , Xu          , Xu          , Uh          , Xu          , Uh          , Xu          , Xu          , Xu          , Xu          , Xu          , Xu          , Xu          , Xu          , Xu          
Xu          , Xu          , Xu          , Xu          , Xu          , Xu          , Xu          , Xu          , Xu          , Xu          , Xu          , Uh          , Uh          , Uh          , Uh          , Xu          , Uu          , Xu          , Xu          , Xu          , Xu          , Xu          , Xu          , Xu          , Xu          , Xu          
