border_size=1
usage=map

Xos         , Xos         , Xos         , Xos         , Xos         , Xos         , Xos         , Xos         , Xos         , Xos         , Xos         , Xos         , Xos         , Xos         , Xos         , Xos         , Xos         , Xos         , Xos         , Xos         , Xos         , Xos         , Xos         , Xos         , Xos         , Xos         , Xos         , Xos         , Xos         , Xos         , Xos         , Xos         , Xos         , Xos         , Xos         , Xu          , Qxu         , Qxu         , Qxu         , Qxu         , Qxu         , Qxu         
Xos         , Xos         , Xos         , Xos         , Xos         , Xos         , Xos         , Xos         , Xos         , Xos         , Xos         , Xos         , Xos         , Xos         , Xos         , Xos         , Xos         , Xos         , Xos         , Xos         , Xos         , Xos         , Xos         , Xos         , Xos         , Xos         , Xos         , Xos         , Xos         , Xos         , Xos         , Xos         , Xos         , Xos         , Xu          , Xu          , Qxu         , Qxu         , Qxu         , 3 Qxu       , Qxu         , Qxu         
Xos         , Xos         , Xos         , Xos         , Xos         , Xos         , Xos         , Xos         , Xos         , Xos         , Xos         , Xos         , Xos         , Xos         , Xos         , Xos         , Xos         , Xos         , Xos         , Xos         , Xos         , Xos         , Xos         , Xos         , Xos         , Xos         , Xos         , Xos         , Xos         , Xos         , Ur          , Xos         , Ur          , Uu          , Uu          , Xu          , Qxu         , Qxu         , Qxu         , Qxu         , Qxu         , Qxu         
Xos         , Xos         , Xos         , Xos         , Xos         , Xos         , Xos         , Xos         , Xos         , Xos         , Xos         , Xos         , Xos         , Xos         , Xos         , Xos         , Xos         , Xos         , Xos         , Xos         , Xos         , Xos         , Xos         , Xos         , Xos         , Xos         , Xos         , Xos         , Ur          , Ur          , Ur          , Ur          , Ur          , Uu          , Uu          , Xu          , Xu          , Qxu         , Qxu         , Qxu         , Qxu         , Qxu         
Xos         , Xos         , Xos         , Xos         , Xos         , Xos         , Xos         , Xos         , Xos         , Xos         , Xos         , Xos         , Xos         , Xos         , Xos         , Xos         , Xos         , Xos         , Xos         , Xos         , Xos         , Xos         , Xos         , Xos         , Xos         , Xos         , Xos         , Xos         , Rr          , Ur          , Xos         , Ur          , Xu          , Uu          , Uu          , Uu          , Xu          , Qxu         , Qxu         , Qxu         , Xu          , Xu          
Xos         , Xos         , Xos         , Xos         , Xos         , Xos         , Xos         , Xos         , Xos         , Xos         , Xos         , Xos         , Xos         , Xos         , Xos         , Xos         , Xos         , Xos         , Xos         , Xos         , Rr^Ii       , Rr^Ii       , Rr^Ii       , Xos         , Xos         , Xos         , Rr          , Rr          , Xos         , Xos         , Xu          , Xos         , Xu          , Uu          , Uu          , Uu          , Uu          , Qxu         , Xu          , Xu          , Ww          , Ww          
Xos         , Xos         , Xos         , Xos         , Xos         , Xos         , Xos         , Xos         , Xos         , Xos         , Xos         , Xos         , Xos         , Xos         , Xos         , Xos         , Xos         , Xos         , Cv^Ii       , Cv^Ii       , Rr^Ii       , Rr^Ii       , Rr^Ii       , Cv^Ii       , Cv^Ii       , Xos         , Xos         , Xos         , Xu          , Xu          , Wo          , Xu          , Xu          , Xu          , Xu          , Uu          , Uu          , Uu          , Uu          , Ww          , Wo          , Wo          
Xos         , Xos         , Xos         , Xos         , Xos         , Xos         , Xos         , Xos         , Xos         , Xos         , Xos         , Xos         , Xos         , Xos         , Xos         , Xos         , Xos         , Xos         , Cv^Ii       , Rr^Ii       , Rr^Ii       , 2 Rr^Ii     , Rr^Ii       , Rr^Ii       , Cv^Ii       , Xos         , Xu          , Xu          , Wo          , Wo          , Wo          , Wo          , Xu          , Xu          , Xu          , Uu          , Ww          , Uu          , Ww          , Ww          , Wo          , Wo          
Xos         , Xos         , Xos         , Xos         , Xos         , Xos         , Xos         , Xos         , Xos         , Xos         , Xos         , Xos         , Xos         , Xos         , Xos         , Xos         , Xos         , Xos         , Cv^Ii       , Rr^Ii       , Rr^Ii       , Rr^Ii       , Rr^Ii       , Rr^Ii       , Cv^Ii       , Xos         , Xu          , Ww          , Wo          , Wo          , Wo          , Wo          , Wo          , Xu          , Xu          , Xu          , Ww          , Ww          , Ww          , Ww          , Wo          , Wo          
Xos         , Xos         , Xos         , Xos         , Xos         , Xos         , Xos         , Xos         , Xos         , Xos         , Xos         , Xos         , Xos         , Xos         , Xos         , Xos         , Xos         , Xos         , Cv^Ii       , Rr^Ii       , Rr^Ii       , Rr^Ii       , Rr^Ii       , Rr^Ii       , Cv^Ii       , Xos         , Xu          , Wo          , Xu          , Xu          , Wo          , Wo          , Xu          , Xu          , Xu          , Xu          , Ww          , Ww          , Wo          , Wo          , Wo          , Wo          
Xos         , Xos         , Xos         , Xos         , Xos         , Xos         , Xos         , Xos         , Xos         , Xos         , Xos         , Xos         , Xos         , Xos         , Xos         , Xos         , Xos         , Xos         , Xos         , Rr^Ii       , Xos         , Rr^Ii       , Xos         , Xos         , Xos         , Xos         , Xu          , Wo          , Ww          , Xu          , Xu          , Wo          , Ww          , Xu          , Ww          , Ww          , Ww          , Ww          , Ww          , Wo          , Wo          , Wo          
Xos         , Xos         , Xos         , Xos         , Xos         , Xos         , Xos         , Xos         , Xos         , Xos         , Xos         , Xos         , Xos         , Xos         , Xos         , Xos         , Xos         , Xos         , Xos         , Xos         , Xos         , Rr^Ii       , Xos         , Xos         , Xos         , Xos         , Xos         , Xu          , Ww          , Ww          , Xu          , Xu          , Ww          , Ww          , Ww          , Ww          , Ww          , Ww          , Ww          , Wo          , Wo          , Wo          
Xos         , Xos         , Xos         , Xos         , Xos         , Xos         , Xos         , Xos         , Xos         , Xos         , Xos         , Xos         , Xos         , Xos         , Xos         , Xos         , Xos         , Xos         , Xos         , Xos         , Cv          , Rr^Ii       , Cv          , Xos         , Xos         , Xos         , Xos         , Xu          , Xu          , Ww          , Ww          , Ww          , Wo          , Wo          , Wo          , Ww          , Ww          , Ww          , Wo          , Wo          , Wo          , Wo          
Xos         , Xos         , Xos         , Xos         , Xos         , Xos         , Xos         , Xos         , Xos         , Xos         , Xos         , Xos         , Xos         , Xos         , Xos         , Xos         , Xos         , Xos         , Cv          , Cv          , Rr          , Rr          , Rr          , Cv          , Cv          , Xos         , Xos         , Xos         , Xos         , Xu          , Xu          , Ww          , Ww          , Ww          , Ww          , Ww          , Ww          , Ww          , Ww          , Ww          , Ww          , Wo          
Xos         , Xos         , Xos         , Xos         , Xos         , Xos         , Xos         , Xos         , Xos         , Xos         , Xos         , Xos         , Xos         , Xos         , Xos         , Xos         , Cv          , Cv          , Rr          , Rr          , Cv          , Cv          , Cv          , Rr          , Rr          , Cv          , Cv          , Xos         , Xos         , Xu          , Xu          , Xu          , Xu          , Xu          , Uu^Uf       , Uu^Uf       , Uu^Uf       , Uu^Uf       , Uu^Uf       , Uu^Uf       , Uu^Uf       , Xu          
Xos         , Xos         , Xos         , Xos         , Xos         , Xos         , Xos         , Xos         , Xos         , Xos         , Xos         , Xos         , Xos         , Xos         , Xos         , Xos         , Xos         , Rr          , Rr          , Cv          , Xos         , Xos         , Xos         , Cv          , Rr          , Rr          , Xos         , Xos         , Xos         , Xos         , Xu          , Xu          , Xu          , Xu          , Uu^Uf       , Xu          , Uu^Uf       , Uu^Uf       , Uu^Uf       , Uu^Uf       , Xu          , Uu^Uf       
Xos         , Xos         , Xos         , Xos         , Xos         , Xos         , Xos         , Xos         , Xos         , Xos         , Xos         , Xos         , Xos         , Xos         , Xos         , Xos         , Xos         , Xos         , Rr          , Xos         , Cv          , Cv          , Cv          , Xos         , Rr          , Xos         , Xos         , Xos         , Xos         , Xos         , Xu          , Xu          , Xu          , Xu          , Uu^Uf       , Uu^Uf       , Uu          , Cud         , Uu          , Uu          , Xu          , Xu          
Xos         , Xos         , Xos         , Xos         , Xos         , Xos         , Xos         , Xos         , Xos         , Xos         , Xos         , Xos         , Xos         , Xos         , Xos         , Xos         , Xos         , Cv          , Cv          , Rr          , Rr          , Rr          , Rr          , Rr          , Cv          , Cv          , Xos         , Xos         , Xos         , Xu          , Xu          , Xu          , Xu          , Xu          , Cud         , Uu^Uf       , Uu          , Uu          , Uu          , Uu          , Cud         , Xu          
Xos         , Xos         , Xos         , Xos         , Xos         , Xos         , Xos         , Xos         , Xos         , Xos         , Xos         , Xos         , Xos         , Xos         , Xos         , Xos         , Xos         , Xos         , Xos         , Xos         , Rr          , Rr          , Rr          , Xos         , Xos         , Xos         , Xos         , Xos         , Xos         , Xos         , Xos         , Xu          , Xos         , Xu          , Xu          , Uu          , Cud         , Uu          , Cud         , Uu          , Xu          , Xu          
Xos         , Xos         , Xos         , Xos         , Xos         , Xos         , Xos         , Xos         , Xos         , Xos         , Xos         , Xos         , Xos         , Xos         , Xos         , Xos         , Xos         , Xos         , Xos         , Xos         , Rr          , Rr          , Rr          , Xos         , Xos         , Xos         , Xos         , Xos         , Xos         , Xos         , Xos         , Xos         , Xos         , Xos         , Xu          , Xu          , Xu          , Ur          , Xu          , Xu          , Xu          , Xu          
Xos         , Xos         , Xos         , Xos         , Xos         , Xos         , Xos         , Xos         , Rr          , Xos         , Xos         , Xos         , Xos         , Xos         , Xos         , Xos         , Xos         , Xos         , Rr          , Rr          , Rr          , Rr          , Xos         , Xos         , Xos         , Xos         , Xos         , Xos         , Xos         , Xos         , Xos         , Xos         , Xos         , Xos         , Xu          , Xu          , Ur          , Ur          , Ur          , Xu          , Xu          , Xu          
Xos         , Xos         , Xos         , Xos         , Xos         , Xos         , Rr          , Rr          , Rr          , Rr          , Rr          , Xos         , Xos         , Xos         , Xos         , Xos         , Rr          , Rr          , Rr          , Rr          , Xos         , Xos         , Xos         , Xos         , Xos         , Xos         , Xos         , Xos         , Xos         , Xos         , Xos         , Xos         , Xos         , Xos         , Xu          , Ur          , Ur          , Ur          , Ur          , Ur          , Xu          , Xu          
Xos         , Xos         , Xos         , Xos         , Rr          , Rr          , Rr          , Rr          , Rr          , Rr          , Rr          , Xos         , Xos         , Xos         , Rr          , Rr          , Rr          , Rr          , Xos         , Xos         , Xos         , Xos         , Xos         , Xos         , Xos         , Xos         , Xos         , Xos         , Xos         , Xos         , Cv^Ii       , Xos         , Xos         , Xos         , Xos         , Xu          , Xu          , Ur          , Xu          , Xu          , Xu          , Xu          
Xos         , Xos         , Xos         , Rr          , Rr          , Rr          , Rr          , Rr          , Xos         , Rr          , Rr          , Rr          , Rr          , Rr          , Rr          , Rr          , Xos         , Xos         , Xos         , Xos         , Xos         , Xos         , Xos         , Xos         , Xos         , Xos         , Xos         , Xos         , Cv^Ii       , Cv^Ii       , Rr^Ii       , Cv^Ii       , Cv^Ii       , Xos         , Xos         , Xos         , Xos         , Xu          , Xos         , Xos         , Xos         , Xos         
Xos         , Xos         , Xos         , Xos         , Xos         , Rr          , Xos         , Xos         , Xos         , Xos         , Rr          , Rr          , Rr          , Rr          , Xos         , Xos         , Xos         , Xos         , Xos         , Xos         , Xos         , Xos         , Xos         , Xos         , Xos         , Xos         , Cv^Ii       , Cv^Ii       , Ww^Ii       , Ww^Ii       , Rr^Ii       , Ww^Ii       , Ww^Ii       , Cv^Ii       , Cv^Ii       , Xos         , Xos         , Xos         , Xos         , Xos         , Xos         , Xos         
Xos         , Xos         , Xos         , Xos         , Xos         , Xos         , Xos         , Xos         , Rr          , Rr          , Rr          , Rr          , Xos         , Rr          , Rr          , Xos         , Xos         , Xos         , Rr          , Xos         , Xos         , Xos         , Xos         , Xos         , Cv^Ii       , Cv^Ii       , Ww^Ii       , Ww^Ii       , Ww^Ii       , Ww^Ii       , Rr^Ii       , Ww^Ii       , Ww^Ii       , Ww^Ii       , Ww^Ii       , Cv^Ii       , Cv^Ii       , Xos         , Xos         , Xos         , Xos         , Xos         
Xos         , Xos         , Xos         , Xos         , Xos         , Xos         , Rr          , Rr          , Rr          , Rr          , Xos         , Xos         , Xos         , Xos         , Xos         , Rr          , Rr          , Rr          , Rr          , Rr          , Rr          , Xos         , Xos         , Xos         , Xos         , Ww^Ii       , Ww^Ii       , Ww^Ii       , Rr^Ii       , Rr^Ii       , Gg^Fet      , Rr^Ii       , Rr^Ii       , Ww^Ii       , Ww^Ii       , Ww^Ii       , Xos         , Xos         , Xos         , Xos         , Xos         , Xos         
Xos         , Xos         , Rr          , Xos         , Rr          , Rr          , Rr          , Rr          , Xos         , Xos         , Xos         , Xos         , Xos         , Xos         , Xos         , Rr          , Rr          , Rr          , Rr          , Rr          , Xos         , Xos         , Xos         , Xos         , Xos         , Xos         , Xos         , Rr^Ii       , Rr^Ii       , Cv^Ii       , Gg^Fet      , Cv          , Rr^Ii       , Rr^Ii       , Xos         , Xos         , Xos         , Xos         , Xos         , Xos         , Xos         , Xos         
Xos         , Xos         , Rr          , Rr          , Xos         , Rr          , Rr          , Rr          , Rr          , Xos         , Xos         , Xos         , Xos         , Xos         , Xos         , Xos         , Xos         , Rr          , Xos         , Xos         , Xos         , Xos         , Xos         , Xos         , Xos         , Xos         , Xos         , Xos         , Xos         , Rr^Ii       , Rr^Ii       , Rr^Ii       , Xos         , Xos         , Xos         , Xos         , Xos         , Xos         , Xos         , Xos         , Xos         , Xos         
Xos         , Xos         , Xos         , Rr          , Xos         , Xos         , Xos         , Rr          , Rr          , Rr          , Rr          , Xos         , Xos         , Xos         , Xos         , Xos         , Xos         , Xos         , Xos         , Xos         , Xos         , Xos         , Xos         , Xos         , Xos         , Xos         , Xos         , Xos         , Xos         , Cv          , Rr          , Cv          , Xos         , Xos         , Xos         , Xos         , Xos         , Xos         , Xos         , Xos         , Xos         , Xos         
Xos         , Xos         , Xos         , Xos         , Xos         , Xos         , Xos         , Xos         , Xos         , Rr          , Rr          , Rr          , Rr          , Xos         , Rr          , Rr          , Rr^Ii       , Rr^Ii       , Rr^Ii       , Xos         , Xos         , Xos         , Xos         , Xos         , Xos         , Xos         , Xos         , Xos         , Xos         , Cv          , Rr          , Cv          , Xos         , Xos         , Xos         , Xos         , Xos         , Xos         , Xos         , Xos         , Xos         , Xos         
Xos         , Xos         , Xos         , Xos         , Xos         , Xos         , Xos         , Xos         , Xos         , Xos         , Xos         , Rr          , Rr          , Rr          , Xos         , Xos         , Rr^Ii       , Cv^Ii       , Gg^Fet      , Rr^Ii       , Rr^Ii       , Xos         , Xos         , Xos         , Xos         , Xos         , Xos         , Xos         , Xos         , Cv          , Rr          , Cv          , Xos         , Xos         , Xos         , Xos         , Xos         , Xos         , Xos         , Xos         , Xos         , Xos         
Xos         , Xos         , Xos         , Xos         , Cv          , Xos         , Xos         , Xos         , Xos         , Xos         , Xos         , Rr          , Rr          , Xos         , Xos         , Xos         , Xos         , Rr^Ii       , Rr^Ii       , Cv^Ii       , Rr^Ii       , Rr^Ii       , Xos         , Xos         , Xos         , Xos         , Xos         , Xos         , Xos         , Cv          , Rr          , Cv          , Xos         , Xos         , Xos         , Xos         , Xos         , Xos         , Xos         , Xos         , Xos         , Xos         
Xos         , Xos         , Cv          , Rr          , Ww          , Rr          , Cv          , Xos         , Xos         , Xos         , Xos         , Rr          , Rr          , Xos         , Xos         , Xos         , Xos         , Xos         , Xos         , Rr^Ii       , Xos         , Xos         , Xos         , Xos         , Xos         , Xos         , Xos         , Xos         , Rr          , Rr          , Rr          , Cv          , Xos         , Xos         , Xos         , Xos         , Xos         , Xos         , Xos         , Xos         , Xos         , Xos         
Xos         , Xos         , Rr          , Ww          , Ww          , Ww          , Rr          , Xos         , Xos         , Xos         , Rr          , Rr          , Rr          , Rr          , Rr          , Xos         , Xos         , Xos         , Xos         , Xos         , Xos         , Xos         , Xos         , Xos         , Xos         , Xos         , Rr          , Rr          , Rr          , Rr          , Rr          , Xos         , Xos         , Xos         , Xos         , Xos         , Xos         , Xos         , Xos         , Xos         , Xos         , Xos         
Xos         , Xos         , Rr          , Ww          , Ww          , Ww          , Rr          , Xos         , Rr          , Rr          , Xos         , Rr          , Rr          , Rr          , Rr          , Rr          , Rr          , Xos         , Xos         , Xos         , Xos         , Xos         , Xos         , Xos         , Rr          , Rr          , Rr          , Rr          , Xos         , Xos         , Rr          , Rr          , Rr          , Xos         , Rr          , Xos         , Rr          , Xos         , Rr          , Xos         , Xos         , Xos         
Xos         , Xos         , Rr          , Ww          , Ww          , Ww          , Rr          , Rr          , Xos         , Xos         , Xos         , Xos         , Xos         , Rr          , Rr          , Rr          , Rr          , Rr          , Rr          , Xos         , Cv          , Xos         , Rr          , Rr          , Rr          , Rr          , Xos         , Xos         , Xos         , Xos         , Rr          , Rr          , Rr          , Rr          , Rr          , Rr          , Rr          , Rr          , Rr          , Rr          , Xos         , Xos         
Xos         , Xos         , Rr          , Cv          , Rr          , Rr          , Xos         , Xos         , Xos         , Xos         , Xos         , Xos         , Xos         , Xos         , Xos         , Rr          , Rr          , Rr          , Rr          , Rr          , Cv          , Rr          , Rr          , Rr          , Rr          , Rr          , Xos         , Xos         , Rr          , Rr          , Rr          , Rr          , Rr          , Rr          , Rr          , Rr          , Rr          , Rr          , Rr          , Rr          , Xos         , Xos         
Xos         , Xos         , Xos         , Rr          , Xos         , Xos         , Xos         , Xos         , Xos         , Xos         , Xos         , Xos         , Xos         , Xos         , Xos         , Xos         , Xos         , Rr          , Rr          , Rr          , Rr          , Rr          , Rr          , Rr          , Xos         , Xos         , Xos         , Xos         , Rr          , Rr          , Rr          , Rr          , Rr          , Rr          , Rr          , Rr          , Rr          , Rr          , Rr          , Rr          , Xos         , Xos         
Xos         , Xos         , Xos         , Xos         , Xos         , Xos         , Xos         , Xos         , Xos         , Xos         , Xos         , Xos         , Xos         , Xos         , Xos         , Xos         , Xos         , Cv          , Rr          , Rr          , Cv          , Rr          , Rr          , Cv          , Xos         , Xos         , Xos         , Xos         , Rr          , Rr          , Rr          , Rr          , Rr          , Rr          , Rr          , Rr          , Rr          , Rr          , Rr          , Rr          , Xos         , Xos         
Xos         , Xos         , Xos         , Xos         , Xos         , Xos         , Xos         , Xos         , Xos         , Xos         , Xos         , Xos         , Xos         , Xos         , Xos         , Xos         , Xos         , Rr          , Cv          , Cv          , 1 Kv        , Cv          , Cv          , Rr          , Xos         , Xos         , Xos         , Xos         , Xos         , Rr          , Xos         , Rr          , Xos         , Rr          , Xos         , Rr          , Xos         , Rr          , Xos         , Rr          , Xos         , Xos         
Xos         , Xos         , Xos         , Xos         , Xos         , Xos         , Xos         , Xos         , Xos         , Xos         , Xos         , Xos         , Xos         , Xos         , Xos         , Xos         , Xos         , Rr          , Rr          , Cv          , Cv          , Cv          , Rr          , Rr          , Xos         , Xos         , Xos         , Xos         , Xos         , Xos         , Xos         , Xos         , Xos         , Xos         , Xos         , Xos         , Xos         , Xos         , Xos         , Xos         , Xos         , Xos         
