border_size=1
usage=map

Qlf         , Qlf         , Qlf         , Qlf         , Qlf         , Xu          , Qlf         , Xu          , Qlf         , Qlf         , Qlf         , Qlf         , Qlf         , Xu          , Xu          , Xu          , Uh          , Uh          , Uh          , Uh          , Xu          , Uh          , Uh          , Xu          , Xu          , Xu          , Xu          , Xu          , Xu          , Xu          , Xu          , Xu          , Xu          , Xu          
Xu          , Qlf         , Qlf         , Qlf         , Qxu^Ii      , Xu          , Xu          , Qlf         , Xu          , Qlf         , Qlf         , Qlf         , Xu          , Xu          , Xu          , Xu          , Uu^Vu       , Uh          , Uh          , Uh          , Xu          , Uh          , Uh          , Uu^Vu       , Xu          , Xu          , Xu          , Xu          , Xu          , Xu          , Xu          , Xu          , Xu          , Xu          
Xu          , Xu          , Xu          , Qxu^Ii      , Qxu^Ii      , Xu          , Qxu^Ii      , Qxu^Ii      , Qxu^Ii      , Qlf         , Qlf         , Qlf         , Xu          , Xu          , Xu          , Uu^Vu       , Uu^Vu       , Uh          , Uh          , Chr         , 5 Khr       , Chr         , Uh          , Uh          , Xu          , Xu          , Xu          , Xu          , Xu          , Xu          , Xu          , Xu          , Xu          , Xu          
Qlf         , Qlf         , Qlf         , Qxu^Ii      , Qxu^Ii      , Ur^Ii       , Qxu^Ii      , Qxu^Ii      , Xu          , Xu          , Xu          , Xu          , Xu          , Xu          , Xu          , Xu          , Uh          , Uh          , Uh          , Chr         , Uh          , Chr         , Uh          , Uh          , Xu          , Xu          , Xu          , Xu          , Xu          , Xu          , Xu          , Xu          , Xu          , Xu          
Xu          , Qlf         , Xu          , Qlf         , Qlf         , Qlf         , Qlf         , Xu          , Qlf         , Xu          , Xu          , Xu          , Xu          , Xu          , Uu^Vu       , Xu          , Uh          , Uh          , Uh          , Uh          , Uh          , Uh          , Uh          , Uu^Vu       , Xu          , Xu          , Xu          , Xu          , Xu          , Xu          , Xu          , Xu          , Xu          , Xu          
Xu          , Xu          , Qlf         , Qlf         , Qlf         , Xu          , Xu          , Qlf         , Qlf         , Qlf         , Qlf         , Xu          , Uu          , Uu          , Uu          , Uu          , Xu          , Xu          , Xu          , Uh          , Xu          , Uh          , Xu          , Uh          , Uh          , Xu          , Xu          , Xu          , Xu          , Xu          , Xu          , Xu          , Xu          , Xu          
Xu          , Xu          , Qlf         , Xu          , Xu          , Xu          , Xu          , Xu          , Uu          , Uu          , Uu          , Uu          , Uu          , Uu          , Xu          , Uu          , Xu          , Xu          , Xu          , Xu          , Xu          , Uh          , Uh          , Xu          , Uh          , Uu^Vu       , Uu^Vu       , Xu          , Xu          , Xu          , Xu          , Xu          , Xu          , Xu          
Qlf         , Qlf         , Xu          , Xu          , Xu          , Xu          , Uu          , Uu          , Uu          , Uu          , Uu          , Uu          , Xu          , Xu          , Xu          , Uu          , Xu          , Xu          , Xu          , Xu          , Xu          , Xu          , Xu          , Uh          , Uu          , Xu          , Uu          , Uu          , Uu          , Xu          , Xu          , Xu          , Xu          , Xu          
Xu          , Xu          , Xu          , Xu          , Xu          , Uu          , Uu          , Uu          , Xu          , Uu          , Xu          , Xu          , Xu          , Xu          , Xu          , Uu          , Uu          , Xu          , Xu          , Xu          , Xu          , Xu          , Uu          , Uu          , Xu          , Uu          , Xu          , Uu          , Uu          , Uu          , Xu          , Xu          , Xu          , Xu          
Xu          , Xu          , Xu          , Xu          , Xu          , Xu          , Uu          , Uu          , Xu          , Xu          , Xu          , Xu          , Xu          , Xu          , Xu          , Uu          , Uu          , Uu          , Uu          , Xu          , Xu          , Xu          , Uu          , Uu          , Xu          , Xu          , Xu          , Xu          , Xu          , Uu          , Uu          , Xu          , Xu          , Xu          
Xu          , Xu          , Xu          , Xu          , Cud         , Xu          , Uu          , Uu          , Cud         , Xu          , Uu          , Xu          , Uu          , Xu          , Xu          , Uu          , Xu          , Uu          , Uu          , Xu          , Xu          , Uu          , Xu          , Xu          , Xu          , Xu          , Xu          , Xu          , Xu          , Xu          , Xu          , Uu          , Xu          , Xu          
Uu          , Uu          , Uu          , Xu          , Cud         , Uu^Vud      , Cud         , Uu^Vud      , Cud         , Uu          , Xu          , Uu          , Uu          , Xu          , Uu          , Uu          , Xu          , Xu          , Uu          , Xu          , Xu          , Uu          , Xu          , Xu          , Xu          , Xu          , Xu          , Xu          , Xu          , Xu          , Xu          , Uu          , Uu          , Uu          
Xu          , Uu          , Uu          , Cud         , Uu^Vud      , Xu          , 3 Kud       , Xu          , Uu^Vud      , Cud         , Uu          , Uu          , Uu          , Uu          , Uu          , Uu          , Uu          , Uu          , Uu          , Uu          , Uu          , Uu          , Uu^Vud      , Xu          , Xu          , Xu          , Cud         , Xu          , Xu          , Xu          , Uu^Vud      , Uu          , Uu          , Xu          
Xu          , Uu          , Uu          , Xu          , Xu          , Cud         , Xu          , Cud         , Xu          , Xu          , Xu          , Xu          , Uu          , Uu          , Uu          , Uu          , Xu          , Xu          , Uu          , Uu          , Uu          , Uu          , Uu          , Uu          , Uu^Vud      , Cud         , 4 Kud       , Cud         , Uu^Vud      , Uu          , Uu          , Uu          , Xu          , Xu          
Xu          , Uu          , Uu          , Xu          , Xu          , Uu^Vud      , Cud         , Uu^Vud      , Xu          , Xu          , Xu          , Xu          , Uu          , Uu          , Xu          , Uu          , Uu          , Uu          , Xu          , Xu          , Xu          , Xu          , Uu^Vud      , Uu          , Xu          , Cud         , Cud         , Cud         , Xu          , Uu          , Uu^Vud      , Uu          , Uu          , Xu          
Xu          , Xu          , Uu          , Xu          , Uu          , Cud         , Uu          , Cud         , Uu          , Uu          , Uu          , Uu          , Uu          , Uu          , Xu          , Xu          , Xu          , Uu          , Xu          , Xu          , Xu          , Xu          , Xu          , Xu          , Xu          , Xu          , Uu          , Xu          , Xu          , Xu          , Xu          , Uu          , Uu          , Xu          
Xu          , Xu          , Uu          , Xu          , Uu          , Xu          , Uu          , Xu          , Uu          , Xu          , Xu          , Uu          , Uu          , Uu          , Xu          , Xu          , Xu          , Uu          , Uu          , Xu          , Xu          , Xu          , Xu          , Xu          , Xu          , Uu          , Xu          , Xu          , Xu          , Xu          , Xu          , Xu          , Xu          , Uu          
Xu          , Xu          , Xu          , Uu          , Uu          , Uu          , Uu          , Uu          , Uu          , Xu          , Uu          , Uu          , Uu          , Uu          , Uu          , Xu          , Xu          , Uu          , Uu          , Xu          , Uu          , Uu          , Uu          , Uu          , Uu          , Uu          , Xu          , Xu          , Xu          , Xu          , Xu          , Xu          , Xu          , Xu          
Xu          , Xu          , Xu          , Xu          , Xu          , Uu          , Xu          , Uu          , Uu          , Uu          , Uu          , Xu          , Xu          , Uu          , Uu          , Uu          , Uu          , Xu          , Uu          , Uu          , Xu          , Xu          , Xu          , Xu          , Xu          , Xu          , Xu          , Xu          , Xu          , Xu          , Xu          , Xu          , Xu          , Xu          
Xu          , Xu          , Xu          , Xu          , Xu          , Xu          , Xu          , Xu          , Xu          , Xu          , Xu          , Uu          , Uu          , Uu          , Uu          , Xu          , Uu          , Uu^Vu       , Uu          , Uu          , Xu          , Xu          , Xu          , Xu          , Xu          , Xu          , Xu          , Xu          , Xu          , Xu          , Xu          , Xu          , Xu          , Xu          
Xu          , Xu          , Xu          , Xu          , Xu          , Xu          , Xu          , Xu          , Xu          , Xu          , Xu          , Xu          , Uu^Vu       , Xu          , Xu          , Uu          , Uu          , Xu          , Uu          , Xu          , Xu          , Xu          , Xu          , Xu          , Xu          , Xu          , Xu          , Xu          , Xu          , Xu          , Xu          , Xu          , Xu          , Xu          
Xu          , Xu          , Xu          , Xu          , Xu          , Xu          , Xu          , Xu          , Xu          , Xu          , Xu          , Xu          , Xu          , Uu          , Uu          , Uu          , Uu          , Uu          , Uu          , Xu          , Xu          , Xu          , Xu          , Xu          , Xu          , Xu          , Xu          , Xu          , Xu          , Xu          , Xu          , Xu          , Xu          , Xu          
Xu          , Xu          , Xu          , Xu          , Xu          , Xu          , Xu          , Xu          , Xu          , Xu          , Xu          , Xu          , Xu          , Xu          , Uu          , Xu          , Xu          , Xu          , Uu          , Uu^Vu       , Xu          , Xu          , Xu          , Xu          , Ql          , Xu          , Ql          , Xu          , Xu          , Xu          , Xu          , Xu          , Xu          , Xu          
Xu          , Xu          , Xu          , Xu          , Xu          , Xu          , Xu          , Xu          , Xu          , Xu          , Xu          , Xu          , Xu          , Xu          , Uu^Vud      , Cud         , Cud         , Uu          , Xu          , Xu          , Xu          , Xu          , Ql          , Uu^Vu       , Ql          , Ql          , Ql          , Ql          , Ql          , Xu          , Xu          , Xu          , Ql          , Ql          
Xu          , Xu          , Xu          , Xu          , Xu          , Xu          , Xu          , Xu          , Xu          , Xu          , Xu          , Xu          , Xu          , Cud         , Cud         , 2 Kud       , Uu^Vud      , Cud         , Xu          , Xu          , Xu          , Xu          , Ql          , Ql          , Ql          , Ql          , Ql          , Ql          , Ql          , Ql          , Ql          , Ql          , Ql          , Ql          
Ql          , Ql          , Ql          , Xu          , Xu          , Xu          , Xu          , Xu          , Xu          , Xu          , Xu          , Xu          , Xu          , Xu          , Xu          , Cud         , Xu          , Uu          , Uu          , Xu          , Ql          , Xu          , Ql          , Ql          , Ql          , Ql          , Ql          , Ql          , Ql          , Ql          , Ql          , Ql          , Ql          , Ql          
Ql          , Ql          , Ql          , Ql          , Ql          , Xu          , Xu          , Xu          , Xu          , Xu          , Xu          , Xu          , Xu          , Xu          , Xu          , Uu^Vu       , Uu          , Ql^Bs/      , Ql          , Ql^Bs\      , Uu          , Ql          , Ql          , Ql          , Ql          , Ql          , Ql          , Ql          , Ql          , Ql          , Ql          , Ql          , Ql          , Ql          
Ql          , Ql          , Ql          , Ql          , Xu          , Ql          , Ql          , Ql          , Ql          , Xu          , Ql          , Xu          , Ql          , Ql          , Ql          , Xu          , Uu          , Ql          , Ql          , Ql          , Ql          , Ql^Bs\      , Uu          , Xu          , Xu          , Ql          , Ql          , Ql          , Ql          , Ql          , Ql          , Ql          , Ql          , Ql          
Ql          , Ql          , Ql          , Ql          , Ql          , Ql          , Ql          , Xu          , Xu          , Ql          , Xu          , Ql          , Xu          , Xu          , Ql          , Uu          , Ql^Bs\      , Ql          , Ql          , Ql          , Uu          , Ql^Bs/      , Ql          , Xu          , Xu          , Xu          , Xu          , Ql          , Ql          , Ql          , Ql          , Ql          , Ql          , Ql          
Ql          , Ql          , Ql          , Ql          , Ql          , Ql          , Ql          , Ql          , Ql          , Ql          , Ql          , Xu          , Ql          , Ql          , Ql          , Ql          , Ql          , Uu          , Uu          , Ql^Bs/      , Ql          , Ql^Bs\      , Uu          , Uu^Vu       , Xu          , Xu          , Xu          , Xu          , Xu          , Ql          , Ql          , Ql          , Xu          , Xu          
Xu          , Ql          , Xu          , Ql          , Ql          , Ql          , Ql          , Ql          , Ql          , Ql          , Ql          , Ql          , Ql          , Ql          , Ql          , Ql          , Ql          , Xu          , Xu          , Uu          , Ql^Bs\      , Ql          , Uu          , Ql          , Ql          , Ql          , Ql          , Xu          , Xu          , Xu          , Xu          , Xu          , Xu          , Xu          
Xu          , Xu          , Xu          , Ql          , Ql          , Ql          , Ql          , Ql          , Ql          , Ql          , Ql          , Ql          , Ql          , Ql          , Ql          , Ql          , Ql          , Xu          , Uu^Vu       , Ql          , Ql          , Cud         , 1 Kud       , Cud         , Ql          , Ql          , Ql          , Ql          , Ql          , Xu          , Xu          , Xu          , Xu          , Xu          
Xu          , Xu          , Xu          , Xu          , Xu          , Ql          , Xu          , Ql          , Ql          , Ql          , Ql          , Ql          , Xu          , Ql          , Ql          , Ql          , Xu          , Xu          , Xu          , Ql          , Ql          , Ql          , Cud         , Uu          , Uu          , Ql          , Ql          , Ql          , Ql          , Ql          , Xu          , Xu          , Xu          , Xu          
Xu          , Xu          , Xu          , Xu          , Xu          , Xu          , Xu          , Xu          , Xu          , Ql          , Xu          , Xu          , Xu          , Xu          , Xu          , Xu          , Xu          , Xu          , Xu          , Ql          , Ql          , Ql          , Ql          , Ql          , Uu          , Ql          , Ql          , Ql          , Ql          , Ql          , Xu          , Xu          , Xu          , Xu          
