border_size=1
usage=map

Mm^Xm       , Mm^Xm       , Mm^Xm       , Mm^Xm       , Mm^Xm       , Mm          , Mm^Xm       , Mm^Xm       , Mm^Xm       , Mm^Xm       , Mm^Xm       , Mm^Xm       , Mm^Xm       , Mm          , Mm          , Mm          , Mm          , Mm          , Hh          , Hh          , Hh          , Gg          , Gg          , Gg          , Gg          , Gg          , Gg          , Gg          , Re          , Gg          , Gg          , Gg          , Gg          , Gg          , Gg          , Gg          , Ww          , Ww          , Ww          , Ww          , Ww          , Ww          , Ww          , Gg          , Gs^Fmf      , Gs^Fmf      , Gs^Fmf      , Gs^Fmf      , Gs^Fmf      , Gg          , Gs^Fmf      , Gg          
Mm          , Mm^Xm       , Mm          , Mm^Xm       , Mm          , Mm^Xm       , Mm^Xm       , Mm^Xm       , Mm          , Mm^Xm       , Mm          , Mm^Xm       , Mm          , Mm^Xm       , Mm          , Mm^Vhh      , Mm          , Mm          , Hh          , Hh          , Hh^Fmf      , Hh          , Hh          , Gg          , Gg          , Gg          , Gg          , Gg          , Gg          , Re          , Gg          , Gg          , Gg          , Gg          , Gg          , Gg          , Gg          , Ww          , Ww          , Ww          , Ww          , Ww          , Gg          , Ww          , Gg          , Gs^Fmf      , Gs^Fmf      , Gg^Ve       , Gs^Fmf      , Gs^Fmf      , Gs^Fmf      , Gg          
Mm          , Mm          , Mm          , Mm          , Mm          , Mm^Xm       , Mm          , Mm          , Mm^Vhh      , Mm          , Mm          , Mm          , Mm          , Mm          , Mm          , Mm          , Mm          , Mm          , Hh          , Hh          , Hh^Fmf      , Hh^Fmf      , Hh          , Gg          , Gg          , Gg          , Gg          , Gg          , Re          , Re          , Gg          , Gg          , Gg          , Gg          , Gg          , Gg          , Gg          , Ww          , Ww          , Ww          , Ww          , Ww          , Gg          , Ww          , Ww          , Gg^Ve       , Gs^Fmf      , Gs^Fmf      , Cv          , Gs^Fmf      , Gs^Fmf      , Gg          
Mm          , Mm          , Mm          , Mm^Vhh      , Mm          , Mm^Xm       , Mm^Xm       , Mm          , Mm          , Mm          , Ch          , Ch          , Ch          , Mm          , Mm          , Mm          , Hh          , Hh          , Mm          , Hh          , Hh          , Hh^Fmf      , Hh^Fmf      , Hh          , Hh          , Gg          , Gg          , Re          , Gg          , Gg          , Gg          , Gg          , Gg          , Gg          , Gg          , Gg          , Gg          , Gg          , Gg          , Ww          , Ww          , Ww          , Ww          , Gg          , Ww          , Gs^Fmf      , Gs^Fmf      , Gg^Ve       , Cv          , 4 Kv        , Re          , Re          
Mm          , Mm          , Mm          , Mm          , Mm          , Mm          , Mm          , Mm          , Mm          , Mm          , Ch          , 3 Kh        , Ch          , Mm          , Mm          , Mm          , Mm          , Mm          , Mm          , Mm          , Hh          , Hh^Fmf      , Hh^Fmf      , Hh          , Hh          , Gg          , Gg          , Re          , Gg          , Gg          , Gg          , Gg          , Gg          , Gg          , Gg          , Gg          , Gg          , Gg          , Gs^Fmf      , Ww          , Ww          , Ww          , Ww          , Gg          , Ww          , Gs^Fmf      , Cv          , Cv          , Re          , Re          , Gg^Ve       , Gs^Fmf      
Mm          , Mm          , Mm          , Mm          , Mm          , Mm          , Mm          , Mm          , Mm          , Mm          , Mm          , Ch          , Mm          , Mm          , Mm          , Mm          , Mm          , Mm          , Mm          , Mm          , Mm          , Hh          , Hh          , Hh          , Hh          , Gg          , Re          , Re          , Gg          , Gg          , Gg          , Gg          , Gg          , Gg          , Gg          , Gg          , Gg          , Gs^Fmf      , Gs^Fmf      , Gs^Fmf      , Ww          , Ww          , Ww          , Ww          , Gg          , Gs^Fmf      , Re          , Re          , Gs^Fmf      , Gs^Fmf      , Gs^Fmf      , Gs^Fmf      
Mm          , Mm          , Mm          , Mm          , Mm          , Mm          , Mm          , Mm          , Mm          , Mm          , Mm          , Mm          , Mm          , Mm          , Mm          , Mm          , Mm          , Mm          , Mm^Vhh      , Mm          , Mm          , Hh          , Hh          , Hh          , Hh          , Gg          , Re          , Gg          , Gg          , Gg          , Gg          , Gg          , Gg          , Gg          , Gg          , Gg          , Gg          , Gs^Fmf      , Gs^Fmf      , Gg          , Ww          , Ww          , Ww          , Ww          , Gs^Fmf      , Gs^Fmf      , Re          , Gs^Fmf      , Gs^Fmf      , Gs^Fmf      , Gs^Fmf      , Gs^Fmf      
Mm          , Mm          , Mm          , Mm          , Mm          , Mm          , Mm          , Mm          , Mm          , Mm          , Mm^Vhh      , Mm          , Mm          , Mm          , Mm          , Mm          , Mm          , Mm          , Mm          , Mm          , Mm          , Mm          , Hh          , Hh          , Hh          , Gg          , Re          , Gg          , Gg          , Gg          , Gg          , Gg          , Gg          , Gg          , Gg          , Gg          , Gg          , Gg          , Gs^Fmf      , Gs^Fmf      , Ww          , Ww          , Ww          , Gg          , Gs^Fmf      , Gg^Ve       , Re          , Gs^Fmf      , Gs^Fmf      , Gs^Fmf      , Gs^Fmf      , Gs^Fmf      
Mm          , Mm          , Mm          , Mm          , Mm          , Mm          , Mm          , Mm          , Mm          , Mm          , Mm          , Mm          , Mm          , Mm          , Mm          , Mm          , Mm          , Mm          , Mm          , Mm          , Mm          , Mm          , Hh          , Hh          , Hh          , Re          , Gg          , Gg          , Gg          , Gg          , Gg          , Gg          , Gg          , Gg          , Gg          , Gg          , Gg          , Gg          , Gg          , Gs^Fmf      , Gg          , Ww          , Ww          , Wo          , Wo          , Gs^Fmf      , Gs^Fmf      , Re          , Gs^Fmf      , Gs^Fmf      , Gs^Fmf      , Gs^Fmf      
Mm          , Mm          , Mm^Vhh      , Mm          , Mm          , Mm          , Mm          , Mm          , Mm          , Mm          , Mm          , Mm          , Mm          , Mm          , Mm          , Mm          , Hh^Fmf      , Hh^Fmf      , Hh^Fmf      , Mm          , Hh          , Hh          , Hh          , Hh          , Hh          , Re          , Gg          , Gg          , Gg          , Gg          , Gg          , Gg          , Gg          , Gg          , Gg          , Gg          , Gg          , Gg          , Gg          , Gg          , Gg          , Ww          , Gg          , Ww          , Wo          , Ww          , Gg          , Re          , Gs^Fmf      , Gs^Fmf      , Gs^Fmf      , Gs^Fmf      
Mm          , Mm          , Mm          , Mm          , Mm          , Mm          , Chr         , Mm          , Mm          , Mm          , Mm          , Mm          , Mm          , Mm          , Hh          , Hh^Fmf      , Hh^Fmf      , Hh^Fmf      , Hh^Fmf      , Hh^Fmf      , Hh^Fmf      , Hh          , Hh          , Hh          , Re          , Re          , Gg          , Gg          , Gg          , Gg          , Gg          , Gg          , Gg          , Gg          , Gg          , Gg          , Gg          , Gg          , Gg          , Gg          , Gg          , Gg          , Gg          , Gg          , Ww          , Wo          , Ww^Bw/      , Re          , Gs^Fmf      , Gg^Ve       , Gs^Fmf      , Gs^Fmf      
Mm          , Mm          , Mm          , Mm          , Mm          , Chr         , 2 Khr       , Chr         , Mm          , Mm          , Mm          , Mm          , Mm          , Mm          , Hh          , Hh^Fmf      , Hh^Fmf      , Hh^Fmf      , Hh          , Hh^Fmf      , Hh^Fmf      , Hh          , Hh          , Gg          , Re          , Gg          , Gg          , Gg          , Gg          , Gg          , Gg          , Gg          , Gg          , Gg          , Gg          , Gg          , Gg          , Gg          , Gg          , Gg          , Gg          , Gg          , Gg          , Gg          , Re          , Wo^Bw/      , Wo          , Gg          , Gg          , Gs^Fmf      , Gs^Fmf      , Gs^Fmf      
Mm          , Mm          , Mm          , Mm          , Mm          , Mm          , Gg          , Chr         , Mm          , Mm^Vhh      , Mm          , Mm          , Hh          , Hh          , Hh          , Hh^Fmf      , Hh          , Hh          , Hh          , Hh^Fmf      , Hh          , Hh          , Re          , Re          , Gg          , Gg          , Gg          , Gg          , Gg          , Gg          , Gg          , Gg          , Gg          , Gg          , Gs^Fmf      , Gg          , Gg          , Gg          , Gg          , Gg          , Gg          , Gg          , Re          , Re          , Ww          , Wo          , Wo          , Ww          , Gs^Fmf      , Gg          , Gs^Fmf      , Gs^Fmf      
Mm          , Mm          , Mm          , Mm          , Mm          , Mm          , Hh          , Hh          , Hh          , Mm          , Hh          , Hh          , Hh          , Hh          , Hh          , Hh          , Re          , Gg          , Re          , Re          , Re          , Re          , Re          , Gg          , Gg          , Gg          , Gg          , Gs^Fmf      , Gs^Fmf      , Gs^Fmf      , Co          , Gg          , Gg          , Gs^Fmf      , Gs^Fmf      , Gg          , Gs^Fmf      , Gs^Fmf      , Gs^Fmf      , Gg          , Gg          , Gg          , Re          , Gg          , Gg          , Ww          , Ww          , Wo          , Wo          , Gg          , Gs^Fmf      , Gg          
Re          , Mm          , Mm          , Mm          , Re          , Re          , Re          , Re          , Re          , Hh          , Hh          , Hh          , Hh          , Hh          , Re          , Re          , Gg          , Re          , Gg          , Gg          , Gg          , Gg          , Gg          , Re          , Re          , Gg          , Gg          , Gs^Fmf      , Gg          , Co          , Gg^Vo       , Gg          , Gg          , Gs^Fmf      , Gs^Fmf      , Co          , Co          , Gs^Fmf      , Gg          , Gg          , Gg          , Re          , Gg          , Gg          , Gs^Fmf      , Gg          , Gs^Fmf      , Ww          , Wo          , Wo          , Gs^Fmf      , Gg          
Mm          , Re          , Re          , Re          , Mm          , Hh          , Hh          , Hh          , Hh          , Re          , Re          , Re          , Re          , Re          , Gg          , Gg          , Hh          , Gg          , Gg          , Gg          , Gg          , Gg          , Gg          , Gg          , Gg          , Re          , Re          , Gg          , Re          , Co          , Gg          , Gg          , Co          , Gs^Fmf      , Gs^Fmf      , Gg^Vo       , Gs^Fmf      , Co          , Gg          , Gg          , Re          , Re          , Gg          , Gs^Fmf      , Gs^Fmf      , Gs^Fmf      , Gg          , Gs^Fmf      , Ww          , Wo          , Gs^Fmf      , Gg          
Mm          , Mm          , Chr         , Mm          , Chr         , Hh          , Hh          , Hh          , Hh          , Hh          , Hh          , Hh          , Hh          , Gg          , Hh          , Hh          , Hh          , Hh          , Gg          , Gg          , Hh          , Gg          , Hh          , Gg          , Gg          , Gg          , Gg          , Re          , Gg          , Re          , Re          , Co          , 7 Ko        , Co          , Co          , Gs^Fmf      , Gs^Fmf      , Co          , Re          , Re          , Gg          , Gg          , Gg          , Gs^Fmf      , Gs^Fmf      , Gg          , Ww          , Ww          , Ww          , Wo          , Gg          , Gg          
Mm          , Mm          , Mm          , Chr         , 1 Khr       , Chr         , Mm          , Mm          , Mm          , Hh          , Hh          , Hh          , Hh          , Hh          , Mm          , Mm          , Mm          , Mm          , Mm          , Gg          , Hh^Fmf      , Hh          , Gg          , Hh          , Gs^Fmf      , Gg          , Gs^Fmf      , Gg          , Gg          , Gg          , Co          , Re          , Re          , Co          , Gg^Vo       , Gg          , Re          , Re          , Gg          , Gg          , Gs^Fmf      , Gs^Fmf      , Gs^Fmf      , Gs^Fmf      , Gs^Fmf      , Gg          , Ww          , Ww          , Ww          , Ww          , Ww          , Gg          
Mm          , Mm          , Chr         , Chr         , Chr         , Chr         , Mm          , Mm          , Mm          , Mm          , Hh          , Hh^Fmf      , Hh          , Hh          , Mm          , Mm          , Mm          , Mm          , Mm          , Mm          , Hh^Fmf      , Hh^Fmf      , Gs^Fmf      , Gs^Fmf      , Hh          , Gs^Fmf      , Gg          , Gg          , Gg^Vo       , Gg          , Gg          , Re          , Co          , Re          , Re          , Gg          , Re          , Gg          , Gg          , Gg          , Gg          , Gg          , Gg          , Gs^Fmf      , Gs^Fmf      , Gg          , Ww          , Ww          , Ww          , Ww          , Ww          , Gg          
Mm          , Mm          , Mm          , Mm          , Mm          , Mm          , Mm          , Mm^Vhh      , Mm          , Hh          , Hh          , Hh^Fmf      , Hh^Fmf      , Hh          , Hh          , Mm          , Mm          , Mm          , Mm          , Mm          , Mm          , Hh^Fmf      , Gs^Fmf      , Gs^Fmf      , Hh          , Gg          , Gg          , Gg          , Gg          , Gg          , Gg          , Re          , Gg          , Gg          , Gg          , Re          , Re          , Gg          , Gg          , Gg          , Gg          , Gg          , Gg          , Gg          , Gg          , Gg          , Gg          , Ww          , Ww          , Ww          , Ww          , Gg          
Mm          , Mm          , Mm          , Mm          , Mm          , Mm          , Mm          , Mm          , Mm          , Hh          , Hh          , Hh          , Hh          , Hh^Fmf      , Hh^Fmf      , Hh          , Hh          , Mm          , Mm          , Mm          , Gs^Fmf      , Gs^Fmf      , Hh^Fmf      , Gg          , Gg          , Gg          , Gg          , Gg          , Gg          , Gg          , Re          , Re          , Gg          , Gg^Vo       , Gg          , Gg          , Gg          , Re          , Re          , Gg          , Gg          , Gg          , Re          , Gg          , Gg          , Gg          , Gg          , Ww          , Ww          , Ww          , Ww          , Gg          
Mm          , Mm^Vhh      , Mm          , Mm          , Mm          , Mm          , Mm          , Mm          , Mm          , Mm          , Hh          , Hh          , Hh^Fmf      , Hh^Fmf      , Hh          , Hh          , Hh          , Mm          , Mm          , Mm          , Mm          , Hh^Fmf      , Hh          , Gg          , Gg          , Gg          , Gg          , Gg          , Gg          , Gg          , Re          , Gg          , Gg          , Gg          , Gg          , Gg          , Gg          , Gg          , Gg          , Re          , Re          , Re          , Gg          , Re          , Re          , Gg          , Gg          , Gg          , Ww          , Ww          , Ww          , Ww          
Mm          , Mm          , Mm          , Mm          , Mm          , Mm          , Mm          , Mm          , Mm          , Mm          , Hh          , Hh^Fmf      , Hh          , Hh          , Mm          , Hh          , Mm          , Mm          , Mm          , Mm          , Hh^Fmf      , Hh          , Hh          , Gg          , Gg          , Gg          , Gg          , Gg          , Gg          , Gg          , Re          , Gg          , Hh          , Hh          , Hh          , Gg          , Gg          , Gg          , Gg          , Gg          , Gg          , Gg          , Gs^Fmf      , Gg          , Gg          , Re          , Re          , Gg          , Gg          , Ww          , Ww          , Ww          
Mm          , Mm          , Mm          , Mm          , Mm          , Mm          , Mm          , Mm          , Hh          , Hh          , Hh          , Hh^Fmf      , Hh          , Mm          , Mm          , Mm          , Mm          , Mm          , Mm          , Mm          , Gg          , Gg          , Gg          , Hh          , Gg          , Gg          , Gg          , Gg          , Gg          , Re          , Gg          , Gg          , Hh          , Hh          , Hh          , Hh          , Gg          , Gg          , Gg          , Gg          , Gg          , Gg          , Gg          , Gg          , Gg          , Gg          , Gg          , Re          , Re          , Ww          , Ww          , Ww          
Mm^Xm       , Mm^Xm       , Mm^Xm       , Mm          , Mm          , Mm          , Mm          , Mm          , Hh          , Hh          , Hh          , Hh          , Mm          , Mm          , Mm          , Mm          , Mm          , Mm          , Hh^Vhh      , Gg          , Hh          , Gg          , Gg          , Gg          , Gg          , Gg          , Gg          , Gg          , Gg          , Re          , Gg          , Hh          , Gg          , Hh          , Hh^Fmf      , Hh^Fmf      , Gg          , Gg          , Gg          , Gg          , Gg          , Gg          , Gg          , Gg^Vh       , Gg          , Gg          , Gs^Fmf      , Gg          , Re          , Gg          , Ww          , Ww          
Mm^Xm       , Mm^Xm       , Mm^Xm       , Mm          , Mm          , Mm          , Mm^Vhh      , Mm          , Mm          , Hh          , Mm          , Mm          , Mm^Vhh      , Mm          , Mm          , Mm          , Mm          , Ch          , Ch          , Hh          , Gg          , Gg          , Gg          , Gg          , Gg          , Gg          , Gg          , Gg          , Gg          , Re          , Gg          , Gg          , Gg          , Gg          , Gs^Fmf      , Hh^Fmf      , Gs^Fmf      , Gg          , Gg          , Gs^Fmf      , Gg          , Gg          , Gg          , Gs^Fmf      , Gg          , Gg          , Gg          , Gg          , Re          , Gg          , Gg          , Gg          
Mm^Xm       , Mm^Xm       , Mm^Xm       , Mm          , Mm          , Mm          , Mm          , Mm          , Mm          , Mm          , Mm          , Mm          , Mm          , Mm          , Mm          , Mm          , Mm          , 6 Kh        , Ch          , Hh          , Gg          , Gg          , Gg          , Gg          , Hh^Fmf      , Hh^Fmf      , Hh^Fmf      , Hh^Fmf      , Gg          , Re          , Gg          , Gg          , Gg          , Gs^Fmf      , Gg          , Gs^Fmf      , Gs^Fmf      , Gs^Fmf      , Gs^Fmf      , Gs^Fmf      , Gs^Fmf      , Gg          , Gs^Fmf      , Gs^Fmf      , Gs^Fmf      , Gg          , Gg^Vh       , Gg          , Re          , Ch          , 5 Kh        , Gg          
Mm^Xm       , Mm^Xm       , Mm^Xm       , Mm^Xm       , Mm^Xm       , Mm          , Mm          , Mm          , Mm          , Mm          , Mm          , Mm          , Mm          , Mm          , Mm          , Mm          , Mm          , Mm          , Ch          , Hh          , Gg          , Gg          , Gg          , Gg          , Hh^Fmf      , Hh^Fmf      , Gg          , Gg          , Gg          , Re          , Re          , Gg          , Gg          , Gs^Fmf      , Gg          , Gg          , Gg          , Gs^Fmf      , Gg          , Gs^Fmf      , Gs^Fmf      , Gs^Fmf      , Gg          , Gg          , Gg          , Gg          , Gg          , Gg          , Ch          , Ch          , Re          , Gg          
Mm^Xm       , Mm^Xm       , Mm^Xm       , Mm^Xm       , Mm^Xm       , Mm^Xm       , Mm^Xm       , Mm^Xm       , Mm^Xm       , Mm^Xm       , Mm^Xm       , Mm^Xm       , Mm^Xm       , Mm^Xm       , Mm          , Mm          , Mm          , Hh          , Hh          , Hh          , Hh^Fmf      , Gg^Vh       , Hh^Fmf      , Hh^Fmf      , Gg          , Gg          , Gg          , Gg          , Gg          , Gg^Vh       , Re          , Gg          , Gg          , Gg          , Gg          , Gg          , Gg          , Gs^Fmf      , Gs^Fmf      , Gs^Fmf      , Gs^Fmf      , Gs^Fmf      , Gs^Fmf      , Gg^Vh       , Gg          , Gg          , Gg          , Gg          , Gg          , Gg          , Re          , Gg          
Mm^Xm       , Mm^Xm       , Mm^Xm       , Mm^Xm       , Mm^Xm       , Mm^Xm       , Mm^Xm       , Mm^Xm       , Mm^Xm       , Mm^Xm       , Mm^Xm       , Mm^Xm       , Mm^Xm       , Mm^Xm       , Mm^Xm       , Mm          , Mm          , Mm          , Gg          , Hh          , Gg          , Hh^Fmf      , Hh^Fmf      , Hh^Fmf      , Hh^Fmf      , Hh^Fmf      , Hh^Fmf      , Gg          , Gg          , Gg          , Re          , Gg          , Gg          , Gg          , Gg          , Gg          , Gg          , Gs^Fmf      , Gs^Fmf      , Gs^Fmf      , Gg          , Gs^Fmf      , Gs^Fmf      , Gs^Fmf      , Gg          , Gg          , Gg          , Gg          , Gg          , Gg          , Gg          , Re          
