border_size=1
usage=map

Ur^Ii       , Ur^Ii       , Cud^Ii      , Xu          , Ur^Ii       , Xu          , Xu          , Xu          , Xu          , Xu          , Ur          , Xu          , Ur          , Xu          , Xu          , Xu          , Xu          , Xu          , Xu          , Xu          , Xu          , Xu          , Xu          , Xu          , Xu          , Xu          , Uu          , Xu          , Xu          , Xu          , Xu          , Xu          , Xu          , Xu          , Xu          , Xu          , Xu          
Cud^Ii      , Kud^Ii      , Cud^Ii      , Cud^Ii      , Ur^Ii       , Xu          , Ur          , Xu          , Xu          , Xu          , Xu          , Ur          , Xu          , Xu          , Xu          , Xu          , Xu          , Xu          , Xu          , Xu          , Xu          , Xu          , Xu          , Xu          , Xu          , Xu          , Uu          , Xu          , Xu          , Xu          , Cud         , Xu          , Xu          , Xu          , Xu          , Xu          , Xu          
Cud^Ii      , Cud^Ii      , Cud^Ii      , Cud^Ii      , Ur^Ii       , Ur^Ii       , Ur          , Ur          , Ur          , Xu          , Ur          , Ur          , Xu          , Xu          , Xu          , Xu          , Xu          , Xu          , Uu          , Xu          , Uu          , Xu          , Xu          , Xu          , Xu          , Uu^Vu       , Uu          , Uu          , Uu          , Uu^Vu       , Cud         , Uu^Vu       , Kud         , Xu          , Xu          , Xu          , Xu          
Xu          , Cud^Ii      , Ur^Ii       , Ur^Ii       , Ur^Ii       , Ur^Ii       , Xu          , Ur          , Ur          , Ur          , Ur          , Xu          , Xu          , Xu          , Xu          , Xu          , Uu          , Uu          , Xu          , Uu          , Xu          , Uu          , Xu          , Xu          , Uu          , Uu          , Xu          , Xu          , Xu          , Uu          , Cud         , Cud         , Cud         , Xu          , Xu          , Xu          , Uu          
Xu          , Xu          , Xu          , Xu          , Ur          , Ur          , Xu          , Xu          , Xu          , Uu          , Uu          , Ur          , Ur          , Xu          , Uu          , Xu          , Uu          , Uu          , Uu          , Xu          , Xu          , Uu          , Uu          , Uu          , Uu          , Xu          , Uu          , Xu          , Uu          , Uu          , Uu          , Cud         , Cud         , Xu          , Uu          , Uu          , Xu          
Ur          , Xu          , Ur          , Ur          , Ur          , Ur          , Xu          , Xu          , Xu          , Xu          , Xu          , Uu          , Uu^Vud      , Ur          , Uu^Vud      , Uu          , Xu          , Xu          , Uu          , Xu          , Uu          , Xu          , Uu          , Uu          , Xu          , Uu          , Uu          , Uu          , Uu^Vu       , Uu          , Uu          , Uu^Vu       , Uu          , Uu          , Uu          , Xu          , Xu          
Ur          , Ur          , Ur          , Ur          , Xu          , Xu          , Xu          , Xu          , Xu          , Xu          , Xu          , Uu          , Ur^Ii       , Ur^Ii       , Ur^Ii       , Uu          , Uu          , Xu          , Xu          , Uu          , Xu          , Uu          , Xu          , Xu          , Xu          , Xu          , Xu          , Xu          , Xu          , Xu          , Xu          , Uu          , Xu          , Uu          , Uu          , Xu          , Uu          
Ur          , Ur          , Xu          , Xu          , Xu          , Xu          , Xu          , Xu          , Xu          , Xu          , Xu          , Uu          , Uu^Vud      , Ur^Ii       , Uu^Vud      , Uu          , Uu          , Xu          , Xu          , Xu          , Xu          , Xu          , Xu          , Xu          , Xu          , Xu          , Xu          , Xu          , Xu          , Xu          , Xu          , Xu          , Xu          , Xu          , Xu          , Uu          , Xu          
Xu          , Xu          , Xu          , Xu          , Xu          , Xu          , Xu          , Xu          , Xu          , Xu          , Uu          , Uu          , Uu          , Uu          , Uu          , Uu          , Uu          , Xu          , Uu^Vu       , Xu          , Xu          , Xu          , Xu          , Xu          , Xu          , Xu          , Uu^Vu       , Xu          , Xu          , Xu          , Xu          , Xu          , Xu          , Xu          , Xu          , Xu          , Xu          
Xu          , Xu          , Xu          , Xu          , Xu          , Xu          , Xu          , Xu          , Uu          , Uu          , Xu          , Uu          , Xu          , Xu          , Xu          , Uu          , Uu          , Uu          , Uu          , Xu          , Xu          , Xu          , Xu          , Xu          , Xu          , Xu          , Uu          , Uu          , Uu          , Xu          , Xu          , Xu          , Xu          , Xu          , Xu          , Xu          , Xu          
Xu          , Xu          , Xu          , Xu          , Xu          , Xu          , Xu          , Uu          , Xu          , Xu          , Xu          , Uu          , Xu          , Xu          , Xu          , Uu^Vu       , Xu          , Uu          , Uu          , Uu          , Uu          , Xu          , Uu^Vu       , Xu          , Xu          , Xu          , Uu          , Uu          , Uu          , Xu          , Xu          , Xu          , Xu          , Xu          , Xu          , Xu          , Xu          
Xu          , Xu          , Xu          , Xu          , Xu          , Xu          , Xu          , Uu          , Xu          , Xu          , Uu          , Uu          , Xu          , Xu          , Xu          , Xu          , Xu          , Xu          , Uu^Uf       , Uu          , Uu          , Uu          , Uu          , Xu          , Cud         , Xu          , Cud         , Uu          , Uu^Vu       , Xu          , Xu          , Xu          , Xu          , Xu          , Xu          , Xu          , Xu          
Xu          , Xu          , Xu          , Xu          , Xu          , Xu          , Uu          , Uu          , Uu          , Uu          , Xu          , Xu          , Xu          , Xu          , Xu          , Xu          , Uu^Ufi      , Uu^Ufi      , Uu^Ufi      , Xu          , Uu^Vu       , Uu          , Uu          , Uu          , Uu^Vu       , Uu          , Uu          , Xu          , Xu          , Xu          , Xu          , Xu          , Xu          , Xu          , Xu          , Xu          , Xu          
Xu          , Xu          , Xu          , Xu          , Uu^Vu       , Uu          , Uu          , Uu          , Xu          , Xu          , Xu          , Xu          , Xu          , Xu          , Xu          , Uu^Ufi      , Ww^Ii       , Ww^Ii       , Uu^Ufi      , Xu          , Xu          , Cud         , Uu          , Cud         , Kud         , Cud         , Uu          , Xu          , Xu          , Xu          , Xu          , Xu          , Xu          , Xu          , Xu          , Xu          , Xu          
Xu          , Xu          , Xu          , Xu          , Uu          , Uu          , Uu          , Uu^Vu       , Xu          , Xu          , Xu          , Xu          , Xu          , Xu          , Xu          , Uu^Ufi      , Ww^Ii       , Ww^Ii       , Uu^Ufi      , Xu          , Xu          , Xu          , Uu          , Cud         , Uu^Vu       , Cud         , Uu          , Uu          , Uu          , Xu          , Xu          , Xu          , Xu          , Xu          , Xu          , Xu          , Xu          
Xu          , Uu^Vu       , Uu          , Uu          , Cud         , Uu          , Xu          , Xu          , Xu          , Xu          , Xu          , Xu          , Xu          , Xu          , Xu          , Uu^Ufi      , Uu^Ufi      , Uu^Ufi      , Xu          , Xu          , Xu          , Xu          , Cud         , Uu          , Xu          , Uu          , Uu          , Uu          , Uu          , Xu          , Xu          , Xu          , Xu          , Xu          , Xu          , Xu          , Xu          
Uu          , Uu          , Uu          , Kud         , Cud         , Uu          , Xu          , Xu          , Xu          , Xu          , Xu          , Xu          , Xu          , Xu          , Xu          , Xu          , Xu          , Xu          , Xu          , Xu          , Uu^Vu       , Uu^Vu       , Uu          , Xu          , Xu          , Xu          , Uu          , Uu          , Uu          , Uu          , Qxu^Bs\     , Qxu         , Qxu         , Xu          , Xu          , Xu          , Xu          
Xu          , Xu          , Uu          , Cud         , Uu          , Uu          , Xu          , Xu          , Xu          , Ql          , Ql          , Xu          , Xu          , Xu          , Xu          , Xu          , Xu          , Xu          , Xu          , Xu          , Uu          , Uu          , Uu          , Uu          , Xu          , Xu          , Xu          , Xu          , Uu          , Uu          , Qxu^Bs/     , Uu          , Qxu         , Xu          , Xu          , Xu          , Xu          
Uu          , Uu          , Xu          , Uu^Vu       , Xu          , Xu          , Xu          , Xu          , Ql          , Xu          , Ql          , Ql          , Xu          , Xu          , Xu          , Xu          , Xu          , Xu          , Xu          , Uu^Vu       , Uu^Vu       , Uu          , Uu^Vu       , Uu^Vu       , Xu          , Xu          , Xu          , Uu          , Uu          , Uu          , Qxu         , Qxu         , Qxu         , Qxu         , Xu          , Xu          , Xu          
Ql          , Xu          , Xu          , Xu          , Xu          , Xu          , Xu          , Ql          , Uu          , Ql          , Ql          , Ql          , Xu          , Xu          , Xu          , Xu          , Xu          , Xu          , Xu          , Xu          , Xu          , Xu          , Xu          , Xu          , Xu          , Xu          , Xu          , Xu          , Xu          , Uu          , Xu          , Qxu         , Xu          , Xu          , Xu          , Xu          , Qxu         
Ql          , Ql          , Xu          , Xu          , Xu          , Xu          , Ql          , Ql          , Ql^Bs|      , Ql          , Xu          , Xu          , Xu          , Xu          , Xu          , Xu          , Xu          , Xu          , Xu          , Xu          , Xu          , Xu          , Xu          , Xu          , Xu          , Xu          , Xu          , Xu          , Xu          , Xu          , Xu          , Xu          , Xu          , Xu          , Xu          , Qxu         , Qxu         
Xu          , Ql          , Ql          , Xu          , Xu          , Xu          , Ql          , Ql          , Uu          , Uu          , Uu          , Xu          , Xu          , Xu          , Xu          , Xu          , Xu          , Xu          , Xu          , Xu          , Uh          , Uh          , Uu          , Uu          , Uu          , Xu          , Xu          , Xu          , Xu          , Xu          , Xu          , Xu          , Xu          , Xu          , Qxu         , Qxu         , Qxu         
Xu          , Xu          , Ql          , Xu          , Xu          , Xu          , Xu          , Xu          , Uu          , Uu          , Qlf         , Uu          , Qlf         , Qlf         , Xu          , Xu          , Xu          , Xu          , Xu          , Xu          , Uh          , Uh          , Uh          , Xu          , Uu          , Xu          , Xu          , Xu          , Uh          , Xu          , Xu          , Xu          , Uu          , Uu^Vu       , Uu          , Qxu         , Qxu^Bs/     
Xu          , Xu          , Ql          , Ql          , Ql          , Ql          , Xu          , Uu^Vu       , Uu          , Uu          , Cud         , Cud         , Cud         , Qlf         , Qlf         , Xu          , Xu          , Xu          , Xu          , Xu          , Xu          , Uh          , Uh          , Xu          , Uu          , Xu          , Xu          , Uh          , Uu          , Uh          , Ur          , Ur          , Ur          , Cud         , Ur          , Ur          , Qxu         
Xu          , Xu          , Ql          , Xu          , Xu          , Ql          , Xu          , Xu          , Uu          , Cud         , Uu          , Uu^Vu       , Cud         , Cud         , Cud         , Qlf         , Xu          , Xu          , Xu          , Xu          , Xu          , Xu          , Xu          , Xu          , Uu          , Xu          , Xu          , Uh          , Uu          , Uu          , Uh          , Xu          , Uu          , Ur          , Uu          , Qxu         , Qxu         
Ql          , Xu          , Ql          , Xu          , Ql          , Ql          , Uu^Vu       , Xu          , Uu          , Uu          , Uu          , Kud         , Uu          , Uu^Vu       , Cud         , Qlf         , Xu          , Xu          , Xu          , Xu          , Xu          , Xu          , Xu          , Xu          , Xu          , Uu          , Uu          , Uu          , Uh          , Uu          , Uh          , Xu          , Xu          , Uu          , Uu^Vu       , Qxu         , Qxu         
Ql          , Ql          , Ql          , Ql          , Xu          , Xu          , Uu          , Uu          , Uu          , Uu          , Xu          , Uu          , Qlf         , Cud         , Qlf         , Qlf         , Xu          , Xu          , Xu          , Xu          , Xu          , Xu          , Xu          , Xu          , Uu          , Uu          , Uu          , Xu          , Uh          , Uh          , Xu          , Xu          , Uu          , Xu          , Xu          , Qxu         , Qxu         
Xu          , Xu          , Ql          , Ql          , Xu          , Uu          , Uu          , Uu          , Uu          , Uu^Vu       , Qlf         , Qlf         , Qlf         , Qlf         , Qlf         , Qlf         , Xu          , Xu          , Xu          , Xu          , Uh          , Uh          , Xu          , Uu          , Xu          , Xu          , Uu          , Xu          , Xu          , Xu          , Uh          , Uu          , Xu          , Uu          , Xu          , Qxu         , Qxu         
Xu          , Xu          , Xu          , Ql          , Uu          , Uu          , Uu          , Uu          , Uu          , Uu          , Uu          , Qlf         , Qlf         , Xu          , Xu          , Xu          , Uu^Vu       , Uu^Vu       , Xu          , Uh          , Uh          , Xu          , Xu          , Uu          , Xu          , Xu          , Uh          , Uh          , Uh          , Uu          , Xu          , Xu          , Uu          , Uu          , Xu          , Xu          , Xu          
Xu          , Xu          , Uu          , Uu          , Xu          , Uu          , Xu          , Uu          , Xu          , Xu          , Uu          , Qlf         , Qlf         , Xu          , Xu          , Uu^Vu       , Uu          , Uu          , Uu          , Uu          , Uu          , Uu          , Uu          , Uu          , Xu          , Xu          , Xu          , Uh          , Xu          , Xu          , Uh          , Uu          , Uu^Vu       , Uh          , Xu          , Xu          , Xu          
Xu          , Xu          , Uu          , Uu          , Xu          , Xu          , Uh          , Uh          , Uh          , Uu          , Uu          , Qlf         , Qlf         , Xu          , Xu          , Cud         , Uu          , Cud         , Xu          , Cud         , Uu          , Uu          , Xu          , Xu          , Xu          , Xu          , Xu          , Xu          , Xu          , Xu          , Xu          , Uu^Vu       , Xu          , Xu          , Xu          , Xu          , Xu          
Xu          , Xu          , Uh          , Uu          , Xu          , Xu          , Xu          , Uh          , Uh          , Uu          , Uu          , Qlf         , Qlf         , Qlf         , Xu          , Uu^Vu       , Uu          , Uu^Vu       , Xu          , Kud         , Cud         , Uu          , Uh          , Xu          , Xu          , Xu          , Xu          , Xu          , Xu          , Xu          , Xu          , Xu          , Xu          , Xu          , Xu          , Xu          , Xu          
Xu          , Xu          , Uh          , Uh          , Xu          , Xu          , Xu          , Uh          , Uh          , Xu          , Uu          , Qlf         , Xu          , Xu          , Xu          , Cud         , Uu          , Cud         , Xu          , Uu          , Uu          , Uh          , Uh          , Xu          , Xu          , Xu          , Xu          , Xu          , Xu          , Xu          , Xu          , Xu          , Xu          , Xu          , Xu          , Xu          , Xu          
Xu          , Uh          , Uh          , Uu          , Xu          , Xu          , Xu          , Uh          , Uh          , Uh          , Xu          , Uu          , Xu          , Xu          , Xu          , Xu          , Qxu         , Uu          , Xu          , Xu          , Xu          , Xu          , Xu          , Xu          , Xu          , Xu          , Xu          , Xu          , Xu          , Xu          , Xu          , Xu          , Xu          , Xu          , Xu          , Xu          , Xu          
Xu          , Uh          , Xu          , Uu          , Uu          , Uu          , Uu          , Uu          , Uu          , Xu          , Xu          , Xu          , Xu          , Xu          , Xu          , Xu          , Qxu         , Qxu         , Qxu         , Xu          , Xu          , Xu          , Xu          , Xu          , Xu          , Xu          , Xu          , Xu          , Xu          , Xu          , Xu          , Xu          , Xu          , Xu          , Xu          , Xu          , Xu          
Xu          , Xu          , Ql          , Uu          , Ql          , Uu          , Ql          , Uu          , Ql          , Ql          , Ql          , Xu          , Xu          , Xu          , Xu          , Xu          , Xu          , Qxu         , Xu          , Xu          , Xu          , Xu          , Xu          , Xu          , Xu          , Xu          , Xu          , Xu          , Xu          , Xu          , Xu          , Xu          , Xu          , Xu          , Xu          , Xu          , Xu          
Xu          , Ql          , Ql          , Ql          , Ql          , Ql^Bs|      , Ql          , Ql          , Ql          , Ql          , Ql          , Xu          , Xu          , Xu          , Xu          , Xu          , Xu          , Xu          , Xu          , Xu          , Xu          , Xu          , Xu          , Xu          , Xu          , Xu          , Xu          , Xu          , Xu          , Xu          , Xu          , Xu          , Xu          , Xu          , Xu          , Xu          , Xu          
