border_size=1
usage=map

Ur^Ii       , Ur^Ii       , Cud^Ii      , Xu          , Ur^Ii       , Xu          , Xu          , Xu          , Xu          , Xu          , Ur          , Xu          , Ur          , Xu          , Xu          , Xu          , Xu          , Xu          , Xu          , Xu          , Xu          , Xu          , Xu          , Xu          , Xu          , Xu          , Ur          , Xu          , Xu          , Xu          , Xu          , Xu          , Xu          , Xu          , Xu          , Xu          , Xu          
Cud^Ii      , 1 Kud^Ii    , Cud^Ii      , Cud^Ii      , Ur^Ii       , Xu          , Ur          , Xu          , Xu          , Xu          , Xu          , Ur          , Xu          , Xu          , Xu          , Xu          , Uu          , Xu          , Ur          , Ur          , Ur          , Xu          , Xu          , Xu          , Xu          , Xu          , Ur          , Xu          , Xu          , Xu          , Cud         , Xu          , Xu          , Xu          , Xu          , Xu          , Xu          
Cud^Ii      , Cud^Ii      , Cud^Ii      , Cud^Ii      , Ur^Ii       , Ur^Ii       , Ur          , Ur          , Ur          , Xu          , Ur          , Ur          , Xu          , Xu          , Xu          , Uu          , Uu          , Uu          , Ur          , Xu          , Uu          , Ur          , Ur          , Xu          , Xu          , Uu^Vu       , Uu          , Ur          , Ur          , Uu^Vu       , Cud         , Uu^Vu       , 2 Kud       , Xu          , Xu          , Xu          , Xu          
Xu          , Cud^Ii      , Ur^Ii       , Ur^Ii       , Ur^Ii       , Ur^Ii       , Xu          , Ur          , Ur          , Ur          , Ur          , Xu          , Xu          , Xu          , Xu          , Uu          , Uu          , Ur          , Uu          , Xu          , Xu          , Uu          , Xu          , Ur          , Ur          , Xu          , Xu          , Xu          , Xu          , Ur          , Cud         , Cud         , Cud         , Xu          , Xu          , Ur          , Ur          
Xu          , Xu          , Xu          , Xu          , Ur          , Ur          , Xu          , Xu          , Xu          , Uu          , Uu          , Ur          , Ur          , Xu          , Uu          , Uu          , Ur          , Ur          , Xu          , Xu          , Xu          , Uu          , Uu          , Uu          , Ur          , Xu          , Ur          , Xu          , Ur          , Ur          , Uu          , Cud         , Cud         , Xu          , Ur          , Ur          , Xu          
Ur          , Xu          , Ur          , Ur          , Ur          , Ur          , Xu          , Xu          , Xu          , Xu          , Xu          , Uu          , Uu^Vud      , Ur          , Uu^Vud      , Ur          , Xu          , Xu          , Xu          , Xu          , Xu          , Xu          , Xu          , Uu          , Xu          , Ur          , Uu          , Ur          , Uu^Vu       , Uu          , Uu          , Uu^Vu       , Uu          , Ur          , Uu          , Xu          , Xu          
Ur          , Ur          , Ur          , Ur          , Xu          , Xu          , Xu          , Xu          , Xu          , Xu          , Xu          , Uu          , Ur^Ii       , Ur^Ii       , Ur^Ii       , Uu          , Uu          , Xu          , Xu          , Xu          , Xu          , Xu          , Xu          , Xu          , Xu          , Xu          , Xu          , Xu          , Xu          , Xu          , Xu          , Uu          , Xu          , Uu          , Uu          , Xu          , Uu          
Ur          , Ur          , Xu          , Xu          , Xu          , Xu          , Xu          , Xu          , Xu          , Xu          , Uu          , Uu          , Uu^Vud      , Ur^Ii       , Uu^Vud      , Uu          , Uu          , Xu          , Xu          , Xu          , Xu          , Xu          , Xu          , Xu          , Xu          , Xu          , Xu          , Xu          , Xu          , Xu          , Xu          , Xu          , Xu          , Xu          , Xu          , Uu          , Xu          
Xu          , Xu          , Xu          , Xu          , Xu          , Xu          , Xu          , Xu          , Uu          , Uu          , Uu          , Ur          , Uu          , Uu          , Uu          , Ur          , Ur          , Xu          , Uu^Vu       , Xu          , Xu          , Xu          , Xu          , Xu          , Xu          , Xu          , Xu          , Xu          , Xu          , Xu          , Xu          , Xu          , Xu          , Xu          , Xu          , Xu          , Xu          
Xu          , Xu          , Xu          , Xu          , Xu          , Xu          , Xu          , Uu          , Uu          , Uu          , Uu          , Ur          , Uu          , Uu          , Xu          , Uu          , Uu          , Ur          , Ur          , Xu          , Xu          , Xu          , Xu          , Xu          , Xu          , Xu          , Xu          , Xu          , Xu          , Xu          , Xu          , Xu          , Xu          , Xu          , Xu          , Xu          , Xu          
Xu          , Xu          , Xu          , Xu          , Xu          , Xu          , Uu          , Uu          , Xu          , Uu          , Xu          , Ur          , Uu          , Xu          , Xu          , Uu^Vu       , Xu          , Uu          , Uu          , Ur          , Ur          , Xu          , Uu^Vu       , Xu          , Xu          , Xu          , Uu          , Uu^Vu       , Uu^Vu       , Xu          , Xu          , Xu          , Xu          , Xu          , Xu          , Xu          , Xu          
Xu          , Xu          , Xu          , Xu          , Xu          , Xu          , Xu          , Xu          , Xu          , Xu          , Xu          , Ur          , Uu          , Xu          , Xu          , Xu          , Xu          , Xu          , Uu^Tf       , Uu          , Uu          , Ur          , Ur          , Xu          , Cud         , Xu          , Cud         , Uu          , Uu          , Xu          , Xu          , Xu          , Xu          , Xu          , Xu          , Xu          , Xu          
Xu          , Xu          , Xu          , Xu          , Xu          , Xu          , Xu          , Xu          , Xu          , Xu          , Xu          , Ur          , Ur          , Xu          , Xu          , Xu          , Uu^Tfi      , Uu^Tfi      , Uu^Tfi      , Xu          , Uu^Vu       , Uu          , Uu          , Ur          , Uu^Vu       , Uu          , Uu          , Xu          , Xu          , Xu          , Xu          , Xu          , Xu          , Xu          , Xu          , Xu          , Xu          
Xu          , Xu          , Xu          , Xu          , Uu^Vu       , Xu          , Ur          , Ur          , Ur          , Xu          , Ur          , Uu          , Ur          , Xu          , Uu^Vu       , Uu^Tfi      , Ww^Ii       , Ww^Ii       , Uu^Tfi      , Xu          , Xu          , Cud         , Uu          , Cud         , 4 Kud       , Cud         , Uu          , Xu          , Xu          , Xu          , Xu          , Xu          , Xu          , Xu          , Xu          , Xu          , Xu          
Xu          , Xu          , Xu          , Xu          , Uu          , Uu          , Ur          , Uu^Vu       , Xu          , Ur          , Uu          , Ur          , Xu          , Xu          , Xu          , Uu^Tfi      , Ww^Ii       , Ww^Ii       , Uu^Tfi      , Xu          , Xu          , Xu          , Uu          , Cud         , Uu^Vu       , Cud         , Ur          , Uu          , Uu^Vu       , Xu          , Xu          , Xu          , Xu          , Xu          , Xu          , Xu          , Xu          
Xu          , Uu^Vu       , Uu          , Uu          , Cud         , Ur          , Xu          , Xu          , Xu          , Xu          , Xu          , Uu          , Xu          , Xu          , Xu          , Uu^Tfi      , Uu^Tfi      , Uu^Tfi      , Uu^Vu       , Xu          , Uu          , Xu          , Cud         , Uu          , Xu          , Uu          , Uu          , Ur          , Ur          , Xu          , Xu          , Xu          , Xu          , Xu          , Xu          , Xu          , Xu          
Uu          , Uu          , Uu          , 3 Kud       , Cud         , Uu          , Xu          , Xu          , Xu          , Xu          , Xu          , Xu          , Xu          , Xu          , Xu          , Xu          , Xu          , Xu          , Xu          , Xu          , Uu^Vu       , Uu          , Uu          , Xu          , Xu          , Xu          , Uu^Vu       , Ur          , Uu          , Ur          , Ur          , Ur          , Ur          , Xu          , Ur          , Qxu         , Qxu         
Xu          , Xu          , Ur          , Cud         , Uu          , Uu          , Xu          , Xu          , Xu          , Xu          , Xu          , Xu          , Xu          , Xu          , Xu          , Xu          , Xu          , Xu          , Xu          , Xu          , Xu          , Uu^Vu       , Xu          , Xu          , Xu          , Xu          , Xu          , Xu          , Uu          , Uu          , Qxu         , Qxu         , Uu          , Ur          , Qxu         , Qxu^Bs\     , Qxu^Bs\     
Ur          , Ur          , Xu          , Uu^Vu       , Xu          , Xu          , Xu          , Xu          , Xu          , Xu          , Xu          , Xu          , Xu          , Xu          , Xu          , Xu          , Xu          , Xu          , Xu          , Xu          , Xu          , Xu          , Xu          , Xu          , Xu          , Xu          , Xu          , Uu          , Qxu         , Uu          , Qxu         , Qxu         , Qxu         , Qxu         , Xu          , Qxu         , Qxu         
Xu          , Xu          , Xu          , Xu          , Xu          , Xu          , Xu          , Xu          , Xu          , Xu          , Xu          , Xu          , Xu          , Xu          , Xu          , Xu          , Xu          , Xu          , Xu          , Xu          , Xu          , Xu          , Xu          , Xu          , Xu          , Xu          , Xu          , Xu          , Xu          , Qxu         , Xu          , Qxu         , Xu          , Xu          , Xu          , Xu          , Xu          
Qxu         , Qxu         , Qxu         , Qxu         , Qxu         , Xu          , Uu^Vu       , Xu          , Xu          , Xu          , Xu          , Xu          , Xu          , Xu          , Xu          , Xu          , Xu          , Xu          , Xu          , Xu          , Xu          , Xu          , Xu          , Xu          , Xu          , Xu          , Xu          , Xu          , Xu          , Xu          , Xu          , Xu          , Xu          , Xu          , Xu          , Xu          , Xu          
Qxu^Bs\     , Qxu         , Ur          , Qxu         , Qxu         , Qxu         , Qxu         , Uh          , Uh          , Uh          , Uh          , Xu          , Xu          , Xu          , Xu          , Xu          , Xu          , Xu          , Xu          , Xu          , Uh          , Uh          , Uu          , Uu          , Uu          , Xu          , Xu          , Xu          , Xu          , Xu          , Xu          , Xu          , Xu          , Xu          , Qxu         , Qxu         , Qxu         
Qxu         , Ur          , Ur          , Cud         , Ur          , Ur          , Ur          , Uh          , Uu          , Uh          , Qxu         , Uu          , Qxu         , Qxu         , Xu          , Xu          , Xu          , Xu          , Xu          , Xu          , Uh          , Uh          , Uh          , Xu          , Uu          , Uh          , Uh          , Xu          , Uh          , Xu          , Xu          , Xu          , Uu          , Uu^Vu       , Uu          , Qxu         , Qxu^Bs/     
Qxu         , Ur          , Cud         , Ur          , Uu          , Uh          , Uh          , Ur          , Ur          , Uu^Vud      , Cud         , Cud         , Cud         , Uu^Vu       , Qxu         , Xu          , Xu          , Xu          , Xu          , Xu          , Xu          , Uh          , Uh          , Xu          , Uu          , Uh          , Xu          , Uh          , Uu          , Uh          , Ur          , Ur          , Ur          , Cud         , Ur          , Ur          , Qxu         
Qxu         , Qxu         , Qxu         , Xu          , Uu          , Uh          , Uu          , Xu          , Ur          , Cud         , Uu          , Uu^Vu       , Cud         , Cud         , Qxu         , Xu          , Xu          , Xu          , Xu          , Xu          , Uh          , Uh          , Xu          , Uu          , Uu          , Xu          , Xu          , Uh          , Ur          , Ur          , Uh          , Xu          , Uu          , Ur          , Uu          , Qxu         , Qxu         
Qxu         , Qxu         , Xu          , Qxu         , Xu          , Xu          , Xu          , Xu          , Ur          , Uu          , Uu          , 6 Kud       , Uu          , Uu^Vu       , Qxu         , Xu          , Xu          , Xu          , Xu          , Uh          , Xu          , Xu          , Xu          , Xu          , Xu          , Uu          , Ur          , Ur          , Uh          , Uu          , Uh          , Xu          , Xu          , Uu          , Uu^Vu       , Qxu         , Qxu         
Qxu         , Qxu         , Qxu         , Xu          , Xu          , Xu          , Ur          , Ur          , Uu          , Uu          , Xu          , Uu          , Qxu         , Qxu         , Xu          , Xu          , Xu          , Xu          , Xu          , Uh          , Uh          , Uu          , Uh          , Xu          , Ur          , Ur          , Uu          , Xu          , Uh          , Uh          , Uh          , Xu          , Xu          , Uh          , Xu          , Qxu         , Qxu         
Xu          , Xu          , Qxu         , Xu          , Xu          , Xu          , Uu          , Uu          , Uu          , Uu^Vu       , Qxu         , Qxu         , Qxu         , Qxu         , Xu          , Xu          , Xu          , Xu          , Xu          , Uh          , Uh          , Uh          , Uu          , Ur          , Xu          , Xu          , Uu          , Xu          , Xu          , Xu          , Uh          , Uu          , Xu          , Uu          , Xu          , Qxu         , Qxu         
Xu          , Xu          , Xu          , Xu          , Ur          , Ur          , Qxu         , Qxu         , Uu          , Uu          , Uu          , Qxu         , Qxu         , Xu          , Xu          , Xu          , Uu          , Uu^Vu       , Uh          , Uh          , Uh          , Xu          , Xu          , Ur          , Uu          , Xu          , Uh          , Uh          , Uh          , Uu          , Uu          , Xu          , Uu          , Uu          , Xu          , Xu          , Xu          
Xu          , Xu          , Uu          , Ur          , Xu          , Uu          , Xu          , Uu          , Xu          , Xu          , Uu          , Qxu         , Qxu         , Xu          , Xu          , Uu          , Uu          , Uu          , Ur          , Uh          , Ur          , Ur          , Ur          , Ur          , Uh          , Uh          , Uh          , Uh          , Xu          , Xu          , Uh          , Uu          , Uu^Vu       , Uh          , Xu          , Xu          , Xu          
Xu          , Xu          , Uu          , Ur          , Xu          , Xu          , Uh          , Uh          , Uh          , Uu          , Qxu         , Qxu         , Qxu         , Xu          , Xu          , Uu          , Ur          , Ur          , Xu          , Cud         , Uu^Vu       , Uu          , Xu          , Xu          , Uu^Vu       , Uu          , Uu          , Uu          , Uu          , Uu          , Uh          , Uu^Vu       , Xu          , Xu          , Xu          , Xu          , Xu          
Xu          , Xu          , Uh          , Ur          , Qxu         , Xu          , Xu          , Uh          , Uh          , Uu          , Qxu         , Qxu         , Qxu         , Qxu         , Xu          , Uu^Vu       , Ur          , Uu^Vu       , Xu          , 5 Kud       , Cud         , Uu          , Uh          , Xu          , Xu          , Xu          , Uu          , Xu          , Xu          , Xu          , Uh          , Xu          , Xu          , Xu          , Xu          , Xu          , Xu          
Xu          , Xu          , Uh          , Ur          , Xu          , Xu          , Xu          , Uh          , Uh          , Xu          , Uu          , Qxu         , Qxu         , Xu          , Xu          , Cud         , Ur          , Cud         , Xu          , Uu^Vu       , Uu          , Uh          , Uh          , Uh          , Uh          , Uu          , Uh          , Xu          , Uh          , Xu          , Uh          , Uh          , Xu          , Xu          , Xu          , Xu          , Xu          
Xu          , Uh          , Uh          , Ur          , Xu          , Xu          , Xu          , Uh          , Uh          , Uh          , Qxu         , Qxu         , Xu          , Xu          , Xu          , Uu^Vu       , Ur          , Uu^Vu       , Xu          , Xu          , Xu          , Xu          , Xu          , Xu          , Xu          , Uh          , Xu          , Uh          , Uh          , Uh          , Uh          , Xu          , Xu          , Xu          , Xu          , Xu          , Xu          
Xu          , Uh          , Xu          , Ur          , Ur          , Uu          , Uu          , Uu          , Uu          , Qxu         , Qxu         , Xu          , Xu          , Xu          , Xu          , Cud         , Ur          , Cud         , Qxu         , Qxu         , Qxu         , Qxu         , Qxu         , Xu          , Xu          , Xu          , Xu          , Xu          , Xu          , Xu          , Xu          , Xu          , Xu          , Xu          , Xu          , Xu          , Xu          
Xu          , Xu          , Qxu         , Qxu         , Qxu         , Ur          , Qxu         , Uu          , Qxu         , Qxu         , Qxu         , Xu          , Xu          , Xu          , Xu          , Qxu         , Qxu^Bs|     , Qxu         , Qxu         , Qxu         , Qxu         , Qxu         , Qxu         , Qxu         , Xu          , Xu          , Xu          , Xu          , Xu          , Xu          , Xu          , Xu          , Xu          , Xu          , Xu          , Xu          , Xu          
Xu          , Qxu         , Qxu         , Qxu         , Qxu         , Qxu^Bs|     , Qxu         , Qxu         , Qxu         , Qxu         , Qxu         , Xu          , Xu          , Xu          , Qxu         , Qxu         , Qxu^Bs|     , Qxu         , Qxu         , Qxu         , Qxu         , Qxu         , Qxu         , Qxu         , Xu          , Xu          , Xu          , Xu          , Xu          , Xu          , Xu          , Xu          , Xu          , Xu          , Xu          , Xu          , Xu          
