border_size=1
usage=map

Xu          , Xu          , Xu          , Xu          , Xu          , Xu          , Xu          , Xu          , Uh          , Uh          , Uu          , Uh          , Uh          , Xu          , Xu          , Xu          , Xu          , Xu          , Uh          , Uh          , Uh          , Uh          , Uh          , Xu          , Xu          , Xu          , Xu          , Xu          , Xu          , Xu          
Xu          , Xu          , Xu          , Xu          , Xu          , Xu          , Xu          , Xu          , Uh          , Uu^Vu       , Uu          , Uh          , Uh          , Xu          , Xu          , Xu          , Uu^Vu       , Uh          , Uh          , Uh          , Uh          , Uh          , Uh          , Uh          , Xu          , Xu          , Xu          , Xu          , Xu          , Xu          
Xu          , Xu          , Xu          , Xu          , Xu          , Xu          , Xu          , Xu          , Uh          , Uh          , Uh          , Uu          , Uh          , Uu^Vu       , Uh          , Xu          , Uh          , Uh          , Xu          , Uh          , Uh          , Uu^Vu       , Xu          , Xu          , Xu          , Xu          , Xu          , Xu          , Xu          , Xu          
Xu          , Xu          , Xu          , Xu          , Xu          , Xu          , Xu          , Xu          , Cud         , Uh          , Uh          , Uu          , Uh          , Uh          , Xu          , Uh          , Uh          , Xu          , Xu          , Xu          , Uh          , Xu          , Xu          , Xu          , Xu          , Xu          , Xu          , Xu          , Xu          , Xu          
Uu          , Xu          , Uu          , Xu          , Xu          , Xu          , Cud         , Uu^Vud      , Uh          , Cud         , Uh          , Uu          , Uu^Vu       , Xu          , Xu          , Uh          , Xu          , Uh          , Uh          , Xu          , Uh          , Xu          , Uh          , Xu          , Uu^Vu       , Xu          , Uu          , Uh          , Uu          , Xu          
Uu          , Uu          , Uh          , Uh          , Uu          , Cud         , 4 Kud       , Cud         , Uu^Vud      , Cud         , Uu          , Uh          , Cud         , Xu          , Cud         , Cud         , Cud         , Uu          , Uu          , Uh          , Uu          , Uh          , Uu          , Uu          , Uu          , Uu          , Uu          , Uu          , Uu^Vu       , Uu          
Uu          , Uu          , Uh          , Uh          , Xu          , Cud         , Cud         , Cud         , Uh          , Cud         , Uh          , Uh          , Cud         , Uu^Vud      , Cud         , 3 Kud       , Cud         , Uu          , Uu          , Uu          , Uu          , Xu          , Uu          , Uu          , Uu          , Uu          , Xu          , Xu          , Xu          , Xu          
Xu          , Xu          , Xu          , Xu          , Xu          , Xu          , Uh          , Uu^Vud      , Cud         , Cud         , Uh          , Uh          , Cud         , Uh          , Uu^Vud      , Cud         , Uu^Vud      , Xu          , Xu          , Xu          , Xu          , Uu          , Uh          , Uu          , Uu          , Xu          , Xu          , Xu          , Xu          , Xu          
Xu          , Xu          , Xu          , Xu          , Xu          , Xu          , Cud         , Cud         , Uh          , Uh          , Uh          , Uh          , Uh          , Cud         , Cud         , Uu          , Cud         , Xu          , Xu          , Xu          , Uh          , Uh          , Uh          , Uu          , Uu          , Uu          , Uu          , Xu          , Uu          , Xu          
Xu          , Xu          , Xu          , Xu          , Xu          , Xu          , Xu          , Uu^Vu       , Uh          , Uh          , Uh          , Uu          , Uu          , Uh          , Uu^Vu       , Cud         , Xu          , Xu          , Xu          , Uh          , Uh          , Uh          , Uh          , Xu          , Xu          , Uu          , Uu          , Uu          , Xu          , Uu          
Wo          , Xu          , Xu          , Xu          , Wo          , Xu          , Ww          , Cud         , Uu^Vud      , Uu          , Uh          , Uh          , Uu          , Uh          , Uu          , Xu          , Xu          , Xu          , Uh          , Uh          , Uu          , Uh          , Xu          , Xu          , Xu          , Xu          , Uu          , Uu          , Uu^Vu       , Xu          
Wo          , Wo          , Wo          , Wo          , Wo          , Ww          , Xu          , Cud         , 2 Kud       , Uu^Vud      , Cud         , Uh          , Uu          , Uu          , Uu          , Uu          , Uu          , Uh          , Uu          , Uu          , Uu          , Uu^Vu       , Xu          , Xu          , Xu          , Xu          , Uu          , Uu          , Xu          , Xu          
Wo          , Wo          , Wo          , Wo          , Wo          , Wo          , Ww          , Cud         , Cud         , Cud         , Uu          , Xu          , Uh          , Uu          , Uu          , Uu          , Uu          , Xu          , Xu          , Uu          , Uu          , Xu          , Uh          , Xu          , Uh          , Uh          , Xu          , Uu          , Uu          , Xu          
Xu          , Xu          , Xu          , Xu          , Xu          , Xu          , Xu          , Ww          , Ww          , Xu          , Uu          , Xu          , Uh          , Uh          , Uh          , Xu          , Xu          , Uu          , Uu          , Uu          , Uu          , Uu          , Xu          , Uh          , Uh          , Xu          , Xu          , Xu          , Uu          , Xu          
Xu          , Xu          , Xu          , Xu          , Xu          , Xu          , Xu          , Uu^Uf       , Ww          , Ww          , Wwf         , Uu          , Uu          , Uh          , Xu          , Xu          , Uu^Vu       , Uu          , Xu          , Uu          , Uu          , Xu          , Xu          , Xu          , Uh          , Xu          , Xu          , Xu          , Xu          , Uu          
Xu          , Xu          , Xu          , Xu          , Xu          , Xu          , Xu          , Xu          , Uu          , Wwf         , Ww          , Xu          , Xu          , Xu          , Xu          , Xu          , Xu          , Uu          , Uu          , Uu          , Xu          , Xu          , Uh          , Uh          , Uh          , Xu          , Uu^Vu       , Xu          , Uu          , Uu          
Xu          , Xu          , Xu          , Xu          , Xu          , Xu          , Xu          , Uu          , Uh          , Xu          , Xu          , Ww          , Ww          , Xu          , Xu          , Xu          , Xu          , Uu          , Uu          , Uu          , Uu          , Uu          , Uu^Vu       , Uu          , Xu          , Uu          , Uu          , Uu          , Uu          , Xu          
Uu          , Xu          , Xu          , Xu          , Xu          , Xu          , Xu          , Uu          , Uh          , Xu          , Uu^Uf       , Uu^Uf       , Ww          , Ww          , Ww          , Xu          , Xu          , Xu          , Uu          , Uu          , Uu          , Xu          , Xu          , Xu          , Xu          , Xu          , Xu          , Xu          , Xu          , Xu          
Uu          , Uu          , Uu          , Uu^Vu       , Uh          , Uh          , Uu          , Uu          , Uu^Uf       , Uu^Uf       , Uu^Uf       , Uu^Uf       , Ww          , Ww          , Xu          , Xu          , Xu          , Xu          , Uu          , Uu          , Uu          , Xu          , Xu          , Xu          , Xu          , Xu          , Xu          , Xu          , Xu          , Xu          
Xu          , Uu          , Uu          , Uu          , Uu          , Uu          , Xu          , Uu          , Uu          , Uu^Uf       , Uu^Uf       , Uu^Uf       , Ww          , Ww          , Xu          , Xu          , Xu          , Xu          , Uu          , Uu          , Uu          , Xu          , Xu          , Xu          , Xu          , Xu          , Xu          , Xu          , Xu          , Xu          
Xu          , Xu          , Xu          , Uu          , Xu          , Xu          , Xu          , Xu          , Xu          , Uu          , Uu          , Ww          , Ww          , Ww          , Xu          , Xu          , Xu          , Uu          , Xu          , Uu          , Xu          , Uu          , Xu          , Xu          , Xu          , Xu          , Xu          , Xu          , Xu          , Xu          
Xu          , Xu          , Xu          , Xu          , Xu          , Xu          , Xu          , Xu          , Uu^Uf       , Uu          , Wwf         , Wwf         , Uu          , Xu          , Xu          , Xu          , Uu          , Uu          , Uu          , Uu          , Xu          , Uu          , Uu          , Xu          , Xu          , Xu          , Xu          , Xu          , Xu          , Xu          
Xu          , Xu          , Xu          , Xu          , Xu          , Xu          , Xu          , Xu          , Re          , Re          , Ww          , Wwf         , Uu          , Uu          , Uu          , Xu          , Xu          , Xu          , Uu          , Xu          , Xu          , Uu          , Xu          , Uu          , Uu^Vu       , Xu          , Xu          , Xu          , Xu          , Xu          
Xu          , Xu          , Xu          , Xu          , Xu          , Xu          , Uu^Uf       , Uu^Uf       , Ww          , Ww          , Xu          , Xu          , Uu          , Uu          , Uu          , Uu          , Uu          , Uu          , Uu          , Uu          , Uu          , Uu^Vu       , Xu          , Uu          , Uu          , Xu          , Xu          , Xu          , Xu          , Xu          
Xu          , Xu          , Xu          , Xu          , Xu          , Uu^Vu       , Ww          , Ww          , Re          , Re          , Xu          , Xu          , Xu          , Uu          , Uu          , Xu          , Uu          , Uu          , Xu          , Uu          , Uu          , Uu          , Xu          , Xu          , Uu          , Xu          , Xu          , Xu          , Xu          , Xu          
Xu          , Xu          , Xu          , Xu          , Ww          , Ww          , Uu^Uf       , Re          , Xu          , Xu          , Xu          , Xu          , Xu          , Xu          , Xu          , Uu^Vu       , Uu          , Uu          , Uu          , Xu          , Uu          , Uu          , Uu          , Xu          , Uu          , Xu          , Xu          , Xu          , Xu          , Xu          
Xu          , Xu          , Xu          , Xu          , Ww          , Uu^Uf       , Uu^Uf       , Xu          , Xu          , Xu          , Xu          , Xu          , Xu          , Xu          , Xu          , Xu          , Xu          , Uu          , Uu          , Uu          , Xu          , Uu          , Cud         , Cud         , Cud         , Xu          , Xu          , Xu          , Xu          , Xu          
Xu          , Xu          , Xu          , Wo          , Wo          , Uu^Uf       , Xu          , Xu          , Xu          , Xu          , Xu          , Xu          , Xu          , Xu          , Xu          , Xu          , Xu          , Xu          , Xu          , Xu          , Xu          , Xu          , Cud         , 1 Kud       , Uu^Vud      , Cud         , Cud         , Xu          , Xu          , Xu          
Xu          , Xu          , Wo          , Wo          , Wo          , Xu          , Xu          , Xu          , Xu          , Xu          , Xu          , Xu          , Xu          , Xu          , Xu          , Xu          , Xu          , Xu          , Xu          , Xu          , Xu          , Xu          , Cud         , Uu^Vud      , Xu          , Uu          , Uu          , Xu          , Xu          , Xu          
Wo          , Wo          , Wo          , Wo          , Wo          , Xu          , Xu          , Xu          , Xu          , Xu          , Xu          , Xu          , Xu          , Xu          , Xu          , Xu          , Xu          , Xu          , Xu          , Xu          , Xu          , Xu          , Xu          , Uu          , Uu          , Uu          , Xu          , Xu          , Xu          , Xu          
