border_size=1
usage=map

Ms          , Mm          , Ms          , Ms          , Ms          , Mm          , Ms          , Ms          , Ms          , Mm          , Mm^Xm       , Mm^Xm       , Mm^Xm       , Mm          , Ms          , Ms          , Mm          , Mm          , Mm          , Mm          , Hh          , Gg          , Gg          , Gs^Fmf      , Gs^Fmf      , Gs^Fmf      , Gg          , Gg          , Gs^Fmf      , Gs^Fmf      , Gs^Fmf      , Gg          , Gg          , Gs^Fmf      , Gs^Fmf      , Gg          , Gs^Fmf      , Gg          , Gg          , Gg          , Gs^Fmf      , Gg          
Ms          , Ms          , Ms          , Ms          , Ms          , Ms          , Ms          , Ms          , Ms          , Ms          , Ha          , Mm^Xm       , Mm          , Mm          , Ms          , Ms          , Mm          , Mm          , Mm          , Mm          , Hh          , Hh          , Gs^Fmf      , Gs^Fmf      , Gg          , Gs^Fmf      , Gs^Fmf      , Gg          , Gs^Fmf      , Gs^Fmf      , Gg          , Gs^Fmf      , Gs^Fmf      , Gg          , Gs^Fmf      , Gs^Fmf      , Gs^Fmf      , Gs^Fmf      , Gs^Fmf      , Gg          , Gs^Fmf      , Gs^Fmf      
Ms          , Ha          , Ha          , Ms          , Mm          , Ms          , Mm          , Ms          , Mm          , Mm          , Mm          , Mm          , Ms          , Ms          , Ms          , Mm          , Mm          , Mm          , Hh^Fmf      , Gg          , Hh^Fmf      , Hh^Fmf      , Gg          , Gs^Fmf      , Gs^Fmf      , Gs^Fmf      , Gg          , Gg^Ve       , Gs^Fmf      , Gs^Fmf      , Gs^Fmf      , Gs^Fmf      , Gs^Fmf      , Gs^Fmf      , Gg          , Gg          , Gs^Fmf      , Gs^Fmf      , Gs^Fmf      , Gg          , Gs^Fmf      , Gg          
Ms          , Ms          , Ms          , Mm          , Mm          , Mm          , Mm          , Mm          , Mm          , Mm^Vhh      , Mm          , Ms          , Ms          , Ms          , Ha          , Ha          , Mm          , Mm          , Hh^Fmf      , Hh^Fmf      , Hh^Fmf      , Hh^Fmf      , Gs^Fmf      , Gs^Fmf      , Gs^Fmf      , Gg          , Gs^Fmf      , Gs^Fmf      , Gs^Fmf      , Gs^Fmf      , Gs^Fmf      , Gs^Fmf      , Gg          , Gs^Fmf      , Gs^Fmf      , Gs^Fmf      , Gs^Fmf      , Gs^Fmf      , Gg^Ve       , Gs^Fmf      , Gs^Fmf      , Gs^Fmf      
Ms          , Ms          , Mm          , Mm          , Mm^Vhh      , Mm          , Ch          , Ch          , Ch          , Mm          , Mm          , Mm          , Ms          , Ms          , Ha^Fpa      , Mm          , Mm          , Gg          , Hh^Fmf      , Hh^Fmf      , Hh^Fmf      , Hh^Fmf      , Gs^Fmf      , Gs^Fmf      , Gs^Fmf      , Gs^Fmf      , Gs^Fmf      , Gs^Fmf      , Gg          , Gs^Fmf      , Gs^Fmf      , Gs^Fmf      , Gs^Fmf      , Gs^Fmf      , Gs^Fmf      , Gs^Fmf      , Gs^Fmf      , Gs^Fmf      , Gs^Fmf      , Gs^Fmf      , Gg          , Gs^Fmf      
Ms          , Ms          , Ms          , Mm          , Mm          , Ch          , Ch          , 3 Kh        , Ch          , Hh          , Hh^Fmf      , Mm          , Mm          , Ha^Fpa      , Mm          , Mm          , Hh          , Hh^Fmf      , Gg          , Gg          , Hh          , Hh^Fmf      , Gs^Fmf      , Gs^Fmf      , Gs^Fmf      , Gg          , Gg          , Gg          , Gs^Fmf      , Gs^Fmf      , Gs^Fmf      , Gs^Fmf      , Gs^Fmf      , Gs^Fmf      , Gs^Fmf      , Gs^Fmf      , Gs^Fmf      , Gg          , Gg          , Gs^Fmf      , Rd          , Rd          
Mm          , Ms          , Ha          , Mm          , Mm          , Mm          , Mm          , Mm          , Hh          , Hh^Fmf      , Mm          , Mm          , Mm          , Mm          , Mm          , Hh          , Hh          , Hh          , Hh          , Hh          , Gg          , Hh^Fmf      , Gg          , Gs^Fmf      , Gg          , Gg          , Gs^Fmf      , Gg          , Gs^Fmf      , Gg          , Gg          , Gs^Fmf      , Gs^Fmf      , Gs^Fmf      , Gs^Fmf      , Gs^Fmf      , Gs^Fmf      , Gs^Fmf      , Rd          , Rd          , Gs^Fmf      , Gs^Fmf      
Ms          , Ms          , Mm          , Mm          , Mm          , Mm          , Mm          , Mm          , Hh          , Hh^Fmf      , Mm^Vhh      , Mm          , Mm          , Mm          , Mm          , Mm          , Hh^Fmf      , Gg          , Gg          , Hh          , Gg          , Gg          , Gg          , Gg          , Gg          , Gg          , Gg          , Gs^Fmf      , Gg          , Gg          , Gg          , Gg          , Gg          , Gg          , Gg          , Gg          , Gg          , Rd          , Gs^Fmf      , Gs^Fmf      , Gg          , Gs^Fmf      
Mm^Xm       , Mm          , Mm          , Mm          , Mm          , Mm          , Mm          , Hh^Vhh      , Hh          , Mm          , Mm          , Mm          , Mm          , Mm          , Mm          , Mm          , Hh^Fmf      , Gg          , Gg          , Gg          , Gg          , Gg          , Gg          , Gg          , Gg          , Gg          , Gg          , Gg          , Gg          , Gg          , Gg          , Gg          , Gg          , Gg          , Gg          , Gg          , Gg          , Rd          , Gs^Fmf      , Gg^Ve       , Gs^Fmf      , Gg          
Mm^Xm       , Mm^Xm       , Mm          , Mm          , Mm          , Mm          , Mm          , Gg          , Hh          , Re          , Mm          , Mm          , Mm          , Mm          , Mm          , Gg          , Hh          , Gg          , Gg          , Gg          , Gg          , Gg          , Gg          , Gg          , Gg          , Gg          , Gg          , Gg          , Gg          , Gs^Fmf      , Gg          , Gg          , Gg          , Gg          , Gs^Fmf      , Gg          , Gg          , Rd          , Gg          , Gg          , Gs^Fmf      , Gs^Fmf      
Mm^Xm       , Mm^Xm       , Mm^Xm       , Mm          , Mm          , Mm          , Hh          , Hh          , Gg          , Re          , Hh          , Mm          , Mm          , Mm          , Mm          , Hh          , Mm          , Gg          , Gg          , Gg          , Gg          , Gg          , Gg          , Gg          , Gg          , Gg          , Gg          , Gg          , Gg          , Gs^Fmf      , Gs^Fmf      , Gs^Fmf      , Gs^Fmf      , Gs^Fmf      , Gs^Fmf      , Gs^Fmf      , Gs^Fmf      , Rd          , Gg          , Gg          , Gg          , Gg          
Mm^Xm       , Mm^Xm       , Mm          , Mm          , Hh^Fmf      , Hh          , Hh          , Hh          , Gg          , Re          , Re          , Hh          , Hh          , Mm          , Hh          , Mm          , Hh^Fmf      , Mm          , Gs^Fmf      , Mm          , Gg          , Gg          , Gg          , Gg          , Gg          , Gg          , Gg          , Gg          , Gg          , Gg          , Gg          , Gs^Fmf      , Gg          , Gs^Fmf      , Gs^Fmf      , Gs^Fmf      , Gs^Fmf      , Rd          , Gg          , Gg          , Gg          , Gg          
Mm          , Mm          , Hh^Fmf      , Hh^Fmf      , Hh^Fmf      , Hh^Fmf      , Mm          , Mm          , Gg          , Gg          , Re          , Ch          , Gg          , Hh^Vhh      , Gg          , Hh^Fmf      , Gs^Fmf      , Mm          , Mm          , Mm          , Gg          , Gg          , Gg          , Gg          , Gg          , Gg          , Gg          , Gg          , Gg          , Gg          , Gg          , Gg          , Gg          , Gs^Fmf      , Gs^Fmf      , Gg          , Gg          , Rd          , Gg          , Gg          , Gg          , Gg          
Mm          , Mm          , Hh^Fmf      , Hh^Fmf      , Mm          , Mm          , Mm          , Mm          , Hh^Vhh      , Mm          , Ch          , Re          , Re          , Gs^Fmf      , Gs^Fmf      , Hh^Fmf      , Gs^Fmf      , Mm          , Mm          , Gg          , Gg          , Gg          , Gg          , Gg          , Gg          , Gg          , Gg          , Gg          , Gg          , Gg          , Gg          , Gg          , Gg          , Gg          , Gg          , Gg          , Rd          , Rd          , Gg          , Gg          , Gg          , Gg          
Gg          , Mm          , Hh          , Gg          , Mm          , Mm          , Mm          , Hh          , Mm          , Mm          , Mm          , Hh          , Gg          , Re          , Gs^Fmf      , Gs^Fmf      , Hh^Fmf      , Hh^Fmf      , Gg          , Gg          , Gg          , Gg          , Gg          , Gg          , Gg          , Gg          , Gg          , Gg          , Gg          , Gg          , Gg          , Gg          , Gg          , Gg          , Gg          , Gg          , Rd          , Gg          , Gg          , Gg          , Gg          , Gg          
Gg          , Hh          , Mm          , Mm          , Mm          , Mm          , Mm          , Gg          , Mm          , Mm          , Mm          , Mm          , Hh          , Re          , Re          , Re          , Re          , Hh^Fmf      , Hh^Fmf      , Gg          , Gg          , Gg          , Gs^Fmf      , Gg          , Gg          , Gg          , Gg          , Gg          , Gg          , Gg          , Gg          , Gg          , Gg          , Gg          , Gg          , Gg          , Rd          , Gg          , Gg          , Gg          , Gg          , Gg          
Gg          , Mm          , Mm          , Mm          , Mm          , Mm          , Hh          , Mm          , Mm          , Mm          , Mm          , Mm          , Hh          , Hh^Fmf      , Gs^Fmf      , Gs^Fmf      , Gs^Fmf      , Re          , Gs^Fmf      , Gs^Fmf      , Gs^Fmf      , Gs^Fmf      , Gs^Fmf      , Gg          , Gg          , Gg          , Gg          , Gg          , Gg          , Gg          , Gg          , Gg          , Gg          , Gg          , Gg          , Rd          , Gg          , Gg          , Gg          , Gg          , Rd          , Rd          
Mm          , Mm          , Mm          , Mm          , Gg          , Hh          , Gg          , Mm          , Mm          , Mm          , Hh          , Hh          , Mm          , Hh^Fmf      , Hh^Fmf      , Hh^Fmf      , Hh^Fmf      , Re          , Re          , Gs^Fmf      , Gg          , Gs^Fmf      , Gg          , 1 Gg        , Gg          , Gg          , Gg          , Gg          , Gg          , Gg          , Gg          , Gg          , Gg          , Gg          , Gg          , Rd          , Gg          , Gg          , Rd          , Rd          , Gg          , Gg          
Mm          , Mm          , Mm          , Mm          , Hh          , Hh          , Gg          , Mm          , Mm          , Mm          , Hh          , Mm          , Mm          , Hh          , Mm          , Hh^Fmf      , Hh^Fmf      , Gg          , Gg          , Re          , Re          , Gg          , Gg          , Gg          , Gg          , Gg          , Gg          , Gg          , Gg          , Gg          , Gg          , Gg          , Gg          , Gg          , Gg          , Rd          , Gg^Vh       , Gg          , Rd          , Gg          , Gg          , Gg          
Mm          , Mm          , Mm          , Mm          , Hh          , Gg          , Hh^Fmf      , Hh          , Hh          , Hh          , Gg          , Gg          , Mm          , Mm          , Mm          , Hh^Vhh      , Hh^Fmf      , Gg          , Hh^Fmf      , Gs^Fmf      , Gs^Fmf      , Re          , Re          , Gg          , Gg          , Gg          , Gg          , Gg          , Gg          , Gg          , Gg          , Gg          , Gg          , Gg          , Gg          , Rd          , Rd          , Rd          , Gg          , Gg          , Ww          , Ww          
Mm          , Mm          , Mm          , Mm          , Hh          , Gg          , Hh          , Gg          , Gg          , Gg          , Gg          , Mm          , Gg^Efm         , Mm          , Mm          , Mm          , Mm          , Hh^Fmf      , Hh^Fmf      , Gs^Fmf      , Gs^Fmf      , Gg          , Gg          , Re          , Re          , Re          , Re          , Gg          , Gg          , Gg          , Gg          , Gg          , Gg          , Gg          , Gg          , Gg          , Gg          , Rd          , Ww          , Ww          , Ww          , Ww          
Hh          , Mm          , Mm          , Mm          , Hh^Fmf      , Hh^Fmf      , Gg          , Gg          , Gg^Efm         , Gg          , Gg          , Mm          , Mm          , Mm          , Mm          , Mm          , Mm          , Mm          , Hh^Fmf      , Gs^Fmf      , Gg          , Gg          , Gg          , Gg          , Gg          , Gg          , Gg          , Re          , Re          , Re          , Re          , Gg          , Gg          , Gg          , Re^Gvs      , Re^Gvs      , Gg          , Rd          , Ww          , Gg          , Gg^Wm       , Ww          
Hh          , Hh          , Hh          , Hh          , Hh          , Hh          , Gg          , Gg^Efm         , Gg^Efm         , Gg^Efm         , Gg^Efm         , Gs^Fmf      , Gs^Fmf      , Mm^Vhh      , Hh^Fmf      , Mm          , Hh^Fmf      , Hh^Fmf      , Hh^Fmf      , Gs^Fmf      , Gg          , Gg          , Gg          , Gg          , Gg          , Gg          , Gg          , Gg          , Gg          , Gg          , Gg          , Re          , Re          , Gg          , Re          , Gg^Vh       , Ww          , Ww^Bw|      , Re^Gvs      , Re^Gvs      , Re^Gvs      , Gg          
Gg          , Gg          , Gg          , Gg          , Gg          , Gg          , Gg          , Gg          , Gg^Efm         , Gg^Efm         , Gg^Efm         , Gg          , Gs^Fmf      , Gs^Fmf      , Gs^Fmf      , Hh^Fmf      , Gs^Fmf      , Gs^Fmf      , Gs^Fmf      , Gs^Fmf      , Gg          , Gg          , Gg          , Gg          , Gg          , Gg          , Gg          , Gg          , Gg          , Gg          , Ww          , Gg          , Ww          , Re          , Ww^Bw\      , Ww          , Ch          , Rd          , Re^Gvs      , Re^Gvs      , Re^Gvs      , Gg          
Gg          , Gg          , Gg          , Gg          , Gg^Efm         , Gg          , Gg          , Gg^Efm         , Gg^Efm         , Gg^Efm         , Gg          , Gg^Efm         , Gg^Efm         , Gs^Fmf      , Gs^Fmf      , Gs^Fmf      , Gg          , Gg          , Gg          , Gg          , Gg          , Gg          , Gg          , Gg          , Gg          , Gg          , Gg          , Gg          , Ww          , Ww          , Ww          , Ww          , Ww          , Ww          , Ch          , Rd          , Rd          , Rd          , Gg          , Re^Gvs      , Gg          , Gg          
Gg          , Gg          , Gg^Efm         , Gg          , Gg          , Gg^Efm         , Gg^Efm         , Gg^Efm         , Gg          , Gg^Efm         , Gg^Efm         , Gg^Efm         , Gg          , Gg^Efm         , Gg^Efm         , Gg          , Gg          , Gg          , Gg          , Gg          , Gg          , Gg          , Gg          , Gg          , Gg          , Gg          , Gg          , Ww          , Ww          , Gg^Vh       , Gg          , Ww          , Gg          , Gg          , Gg          , Gg          , Ch          , Ch          , Ch          , Gg          , Gg          , Gg          
Re          , Re          , Re          , Gg^Vh       , Gg          , Gg^Efm         , Gg^Efm         , Gg          , Gg^Efm         , Gg          , Gg^Efm         , Gg^Efm         , Gg^Efm         , Gg^Efm         , Gg          , Gg          , Gg          , Gg          , Gg          , Gg          , Gg          , Gg          , Gg          , Gg          , Gg          , Gg          , Ww          , Ww          , Ww          , Ww          , Ww          , Ww^Bw\      , Gg          , Gg          , Gg          , Gg          , Ch          , 2 Kh        , Ch          , Gg          , Rp^Vhc      , Gg          
Gg          , Gg^Efm         , Gg^Efm         , Re          , Gg^Efm         , Gg^Efm         , Gg^Efm         , Gg^Efm         , Gg          , Gg^Efm         , Gg          , Gg^Efm         , Gg^Efm         , Gg^Efm         , Gg          , Gg          , Gg          , Gg          , Gg          , Gg          , Gg          , Gg          , Gg          , Gg          , Gg          , Gg          , Ww          , Ww          , Ww          , Gg          , Ww          , Gg^Wm       , Re^Gvs      , Gg^Vh       , Gg          , Gg          , Ch          , Ch          , Ch          , Rp          , Rp          , Gg          
Gg          , Gg          , Gg          , Gg^Vh       , Gg          , Gg          , Gg          , Gg^Efm         , Gg^Efm         , Gg          , Gg^Efm         , Gg          , Gg^Efm         , Gg          , Gg          , Gg          , Gg          , Gg          , Gg          , Gg          , Gg          , Gg          , Gg          , Gg          , Gg          , Gg          , Ww          , Ww          , Gg          , Ww          , Ww          , Re^Gvs      , Re^Gvs      , Re^Gvs      , Gg          , Gg          , Gg          , Gg          , Gg          , Gg          , Gg          , Rp          
Gg          , Gg          , Gg          , Gg          , Gg          , Gg          , Gg          , Gg^Efm         , Gg^Efm         , Gg^Efm         , Gg          , Gg          , Gg          , Gg          , Gg          , Gg          , Gg          , Gg          , Gg          , Gg          , Gg          , Gg          , Gg          , Gg          , Gg          , Gg          , Ww          , Ww          , Gg          , Ww          , Gg          , Re^Gvs      , Re^Gvs      , Re^Gvs      , Gg          , Gg          , Gg          , Gg          , Gg          , Gg          , Gg          , Gg          
