border_size=1
usage=map

Ww          , Hh          , Ha^Fda      , Hh          , Ha^Fda      , Hh          , Hh          , Ai          , Ai          , Ai          , Ai          , Ai          , Mm          , Mm          , Mm          , Mm          , Mm          , Mm          , Mm          , Mm          , Mm          , Mm          , Mm          , Mm          , Mm          , Mm          , Mm          , Mm          , Mm          , Mm          , Mm          , Hh          , Hh          , Hh          , Hh          , Hh          , Hh          , Hh          
Gs^Fp       , Ha^Fda      , Ha^Fda      , Ha^Fda      , Ha^Fda      , Mm          , Ha^Fda      , Ai          , Ai          , Ai          , Ww          , Ai          , Mm          , Ai          , Ai          , Ai          , Mm          , Mm          , Mm          , Mm          , Mm          , Mm          , Aa^Fma      , Aa^Fma      , Aa^Fma      , Mm          , Mm          , Mm          , Hh^Fdw      , Hh          , Hh          , Hh          , Ha          , Hh          , Ha          , Ha          , Hh          , Hh          
Gs^Fp       , Ha^Fda      , Ha^Fda      , Ha^Fda      , Ha          , Ha^Fda      , Ha^Fda      , Ha^Fda      , Ai          , Ai          , Ww          , Ww          , Ww          , Ww          , Ww          , Ai          , Mm          , Mm          , Mm          , Mm          , Mm          , Aa^Fma      , Aa^Fma      , Mm          , Aa^Fma      , Aa^Fma      , Mm          , Mm          , Mm          , Aa          , Hh^Fdw      , Ha          , Ha          , Ha          , Ha          , Ha          , Ha          , Hh          
Xu          , Hh          , Hh^Vhh      , Ha          , Ms          , Ha          , Ha          , Ha^Fda      , Ha^Fda      , Ai          , Ai          , Ww          , Ai          , Ww          , Ww          , Ai          , Ww          , Ai          , Mm          , Mm          , Mm          , Mm          , Mm          , Aa^Fma      , Ai          , Aa^Fma      , Aa^Fma      , Hh          , Hh^Vhh      , Aa          , Aa          , Ha          , Ha          , Hh^Fdw      , Hh          , Hh          , Hh          , Hh          
Xu          , Xu          , Xu          , Ha          , Ha          , Ms          , Ms          , Ms          , Ms          , Mm          , Mm          , Ai          , Ai          , Ai          , Ai          , Mm^Vhh      , Mm          , Hh          , Mm          , Mm          , Mm          , Hh          , Hh          , Hh          , Ai          , Ww          , Ai          , Ai          , Aa          , Aa          , Aa          , Ha          , Ha          , Hh^Fdw      , Hh^Fdw      , Hh^Fdw      , Hh          , Hh          
Uh          , Xu          , Xu          , Xu          , Xu          , Ha          , Ha          , Ms          , Ms          , Ms          , Mm          , Mm          , Mm          , Ai          , Ww          , Ww          , Ai          , Ww          , Hh          , Hh          , Ww          , Hh^Vhh      , Ww          , Ai          , Ww          , Ai          , Ai          , Ww          , Aa          , Aa          , Aa          , Ha          , Hh          , Hh^Fdw      , Hh          , Hh          , Hh^Vhh      , Hh          
Ur          , Uh          , Ur          , Uh          , Xu          , Xu          , Ha          , Hh^Fdw      , Mm          , Ms          , Mm          , Mm          , Ww          , Ww          , Hh          , Hh          , Hh          , Ai          , Ww          , Ww          , Ww          , Ww          , Ww          , Ww          , Ww          , Ww          , Ww          , Ww          , Hh          , Hh          , Hh          , Hh          , Hh          , Hh          , Ww          , Ww          , Ww          , Hh          
Ur          , Ur          , Ur          , Uh          , Ur          , Xu          , Uu          , Ha          , Hh          , Ms          , Hh          , Hh          , Hh          , Hh          , Hh          , Hh          , Hh          , Hh          , Hh          , Ww          , Hh          , Hh          , Ww          , Ww          , Ww          , Ww          , Ww          , Hh          , Ww          , Ww          , Ww          , Hh          , Ww          , Ww          , Ww          , Ww          , Ww          , Ww          
Uh          , Uh          , Ur          , Ur          , Uh          , Uu          , Uu          , Hh          , Ms          , Hh          , Re          , Ms          , Ms          , Hh          , Hh          , Hh          , Hh^Fdw      , Hh^Fdw      , Hh^Fdw      , Hh          , Hh          , Hh          , Ww          , Ww          , Ww          , Ww          , Ww          , Ww          , Ww          , Ww          , Ww          , Ww          , Ww          , Ww          , Hh^Fdw      , Hh          , Hh          , Ww          
Uh          , Uh          , Uh          , Ur          , Uh          , Uu^Uf       , Uh          , Ms          , Ms          , Ms          , Re          , Re          , Re          , Re          , Re          , Hh          , Hh          , Hh^Fdw      , Hh^Fdw      , Hh^Fdw      , Hh^Fdw      , Hh          , Hh          , Hh          , Hh          , Hh          , Ww          , Ww          , Ww          , Ww          , Hh^Fdw      , Ww          , Hh^Fdw      , Hh^Fdw      , Hh^Fdw      , Hh^Fdw      , Hh^Fdw      , Ww          
Xu          , Uh          , Uh          , Uh          , Xu          , Xu          , Ms          , Ms          , Mm          , Mm          , Mm          , Mm          , Re          , Mm          , Re          , Re          , Hh          , Hh^Fdw      , Hh^Fdw      , Hh^Fdw      , Hh^Fdw      , Hh^Fdw      , Gs^Fp       , Gs^Fp       , Gg          , Gg          , Gg          , Ww          , Ww          , Ww          , Hh^Fdw      , Hh^Fdw      , Hh^Fdw      , Hh          , Hh^Fdw      , Hh^Fdw      , Hh          , Hh          
Xu          , Xu          , Xu          , Xu          , Ms          , Xu          , Ms          , Ms          , Mm          , Mm          , Mm          , Re          , Mm          , Mm          , Mm          , Re          , Hh          , Hh          , Ha          , Ha          , Gg          , Gg          , Gg^Vh       , Gs^Fp       , Gs^Fp       , Gs^Fp       , Gg          , Ww          , Ww          , Hh^Fdw      , Hh^Fdw      , Gg^Vh       , Hh          , Hh          , Hh          , Hh^Fdw      , Hh          , Gs^Fp       
Xu          , Xu          , Hh          , Hh          , Chr         , Ms          , 2 Khr       , Chr         , Chr         , Chr         , Mm          , Mm          , Mm          , Ww          , Mm^Vhh      , Re          , Re          , Hh          , Hh          , Gg          , Gg          , Gg          , Gg          , Ww          , Ww          , Gg          , Ww          , Ww          , Gg          , Gg          , Gg          , Gg          , Hh          , Hh          , Hh          , Hh          , Hh          , Gs^Fp       
Ha          , Ha          , Ms          , Ms          , Mm          , Chr         , Chr         , Chr         , Mm          , Mm          , Mm          , Mm          , Ww          , Ww          , Ww          , Ww          , Ww          , Re          , Re          , Gg          , Re          , Re          , Ww^Bw\      , Ww          , Ch          , Ww          , Gg          , Ww          , Gg          , Gg          , Gg          , Aa          , Ha          , Ha          , Hh          , Hh          , Hh          , Hh          
Ha          , Ms          , Ms          , Mm^Vhh      , Mm          , Mm          , Mm          , Mm          , Mm          , Mm          , Mm          , Ai          , Ai          , Ai          , Ai          , Ai          , Ha          , Ww          , Gg          , Re          , Gs^Fp       , Ww          , Ww          , Re          , Ww          , Ww^Bw\      , Re          , Ww          , Gg          , Gg          , Gg          , Ha          , Ha          , Ha          , Ce          , Hh          , Hh          , Hh          
Ha          , Ms          , Hh          , Mm          , Mm          , Mm          , Mm          , Mm          , Mm          , Mm          , Ww          , Ww          , Ww          , Ww          , Ai          , Ai          , Ww          , Ww          , Ww          , Ww          , Ww          , Ww          , Gs^Fp       , Gs^Fp       , Ww          , Ww          , Re          , Ww          , Ww          , Ww          , Gg          , Aa          , Ai          , Ai          , Ce          , Ce          , Ce          , Hh          
Ha          , Ms          , Ms          , Ms          , Hh^Fdw      , Hh^Fdw      , Hh^Fdw      , Mm          , Mm          , Mm          , Mm          , Ww          , Ww          , Ww          , Ai          , Ai          , Ww          , Hh          , Gs^Fp       , Gs^Fp       , Gs^Fp       , Gs^Fp       , Gs^Fp       , Gs^Fp       , Gs^Fp       , Gg          , Re          , Ww          , Gg          , Ww          , Ww          , Ha          , Ai          , Ce          , Ce          , 1 Ke        , Ce          , Ww          
Hh          , Hh          , Hh^Fdw      , Ms          , Ms          , Mm          , Mm          , Hh^Fdw      , Mm          , Mm          , Mm          , Ww          , Ww          , Ww          , Ai          , Mm          , Ha          , Ha^Fpa      , Ha^Fpa      , Hh^Fdw      , Gs^Fp       , Gg^Ve       , Gs^Fp       , Gs^Fp       , Gs^Fp       , Gs^Fp       , Gs^Fp       , Re          , Re          , Ww          , Hh          , Ww          , Ha          , Hh          , Hh          , Hh          , Re          , Hh          
Hh          , Hh          , Hh          , Ms          , Hh^Fdw      , Hh^Fdw      , Mm          , Mm          , Mm          , Mm          , Mm          , Mm          , Ww          , Ww          , Mm          , Mm          , Hh          , Ha^Fpa      , Hh^Fdw      , Hh^Fdw      , Gs^Fp       , Gs^Fp       , Gs^Fp       , Gs^Fp       , Gs^Fp       , Gs^Fp       , Gs^Fp       , Gs^Fp       , Re          , Gg^Vh       , Re          , Ha          , Ha          , Hh          , Re          , Re          , Hh          , Re          
Hh          , Ms          , Hh^Fdw      , Hh^Fdw      , Hh^Fdw      , Mm          , Mm          , Mm          , Mm          , Mm          , Mm          , Mm          , Mm          , Mm          , Mm          , Hh          , Hh          , Hh          , Hh^Fdw      , Gg          , Gs^Fp       , Gs^Fp       , Gs^Fp       , Gs^Fp       , Gs^Fp       , Gs^Fp       , Gs^Fp       , Gs^Fp       , Gs^Fp       , Re          , Hh          , Re          , Re          , Re          , Hh          , Ww          , Ww          , Re          
Hh          , Hh^Fdw      , Hh^Fdw      , Hh^Fdw      , Mm          , Mm          , Mm          , Mm          , Mm          , Mm          , Mm          , Mm          , Mm          , Mm          , Mm          , Mm          , Hh          , Hh^Fdw      , Hh^Fdw      , Gg          , Gg          , Gs^Fp       , Gg          , Gg          , Gg          , Gg          , Gs^Fp       , Gs^Fp       , Gg          , Gg          , Gg          , Hh          , Hh          , Hh          , Hh          , Ww          , Ww          , Ww          
Hh          , Hh^Fdw      , Hh          , Mm          , Mm          , Mm          , Mm          , Mm          , Mm          , Mm          , Mm          , Mm          , Mm          , Mm          , Mm^Vhh      , Mm          , Hh          , Hh          , Hh          , Gg          , Gg          , Gg          , Gg          , Gg          , Aa          , Gg          , Gg          , Gg          , Gg          , Gg          , Gg          , Hh          , Hh          , Hh          , Ww          , Ww          , Ww          , Ww          
Hh          , Hh          , Hh          , Mm          , Mm          , Mm          , Mm          , Mm          , Mm          , Mm          , Mm          , Mm          , Mm          , Mm          , Mm          , Hh          , Hh          , Hh          , Gg          , Aa          , Aa          , Aa          , Aa          , Aa          , Aa          , Aa          , Aa          , Aa          , Aa          , Gg          , Gg          , Hh          , Hh          , Ww          , Ww          , Ww          , Ww          , Ww          
Hh          , Hh          , Hh          , Mm          , Mm          , Mm          , Mm          , Mm          , Mm          , Mm          , Mm          , Mm          , Mm          , Mm          , Mm          , Ha          , Ha          , Ha          , Aa          , Aa          , Aa          , Aa          , Aa          , Aa          , Aa          , Aa          , Aa          , Aa          , Aa          , Gg          , Gg          , Hh          , Hh          , Ww          , Ww          , Ww          , Ww          , Mm          
