border_size=1
usage=map

Ww          , Ww          , Gs^Fp       , Gs^Fp       , Gg          , Gg          , Gg          , Gg          , Gg          , Hh          , Ww          , Gg          , Gg          , Gg          , Ww          , Re          , Gg          , Re          , Gg          , Ch          , Gs^Fp       , Re          , Gg          , Gg          , Gg          , Gg          
Gs^Fp       , Gs^Fp       , Gs^Fp       , Gs^Fp       , Gg          , Gg          , Gg          , Gg          , Gg          , Hh          , Re          , Gg          , Hh          , Gg          , Hh          , Hh          , 1 Re        , Re          , Gg          , Gs^Fp       , Gs^Fp       , Gs^Fp       , Gg          , Gg          , Gg          , Gg          
Gs^Fp       , Gs^Fp       , Gs^Fp       , Gs^Fp       , Gg          , Gg          , Ww          , Ww          , Ww          , Re          , Hh          , Re          , Re          , Re          , Re          , Re          , Ww          , Gg          , Ww          , Ww          , Ww          , Gg          , Gg          , Gg          , Gg          , Gg          
Gs^Fp       , Gs^Fp       , Gs^Fp       , Gs^Fp       , Gs^Fp       , Gg          , Ce          , Gg          , Re          , Re          , Gg^Vh       , Gg          , Ds          , Ds          , Ds          , Gg          , Gg          , Gg          , Ds          , Ww          , Ww          , Gg          , Gg          , Gg          , Gg          , Gg          
Gs^Fp       , Gs^Fp       , Gs^Fp       , Gs^Fp       , Gs^Fp       , Ce          , 2 Ke        , Ce          , Re          , Gg          , Gs^Fp       , Ds          , Ds          , Ds          , Ww          , Ds          , Ds          , Ds          , Ww          , Ww          , Ww          , Ww          , Ww          , Gg          , Gg          , Gs^Fp       
Ww          , Gg          , Gg          , Gg          , Gg          , Ce          , Re          , Re          , Gg          , Gg          , Gs^Fp       , Gs^Fp       , Gs^Fp       , Ww          , Ww          , Ww          , Gg          , Ww          , Ww          , Ww          , Ww          , Ww          , Ww          , Gg          , Gs^Fp       , Ww          
Ww          , Ww          , Gg          , Gg          , Gg          , Gs^Fp       , Re          , Gs^Fp       , Gg^Ve       , Gs^Fp       , Gs^Fp       , Gs^Fp       , Gs^Fp       , Ww          , Gg^Vh       , Gg          , Gg          , Ww          , Ww          , Ww          , Ww          , Gg          , Gg          , Ww          , Ww          , Ww          
Ww          , Gg          , Gg          , Gg          , Re          , Re          , Gs^Fp       , Gs^Fp       , Gs^Fp       , Gs^Fp       , Hh          , Gs^Fp       , Gs^Fp       , Ww          , Gg          , Ww          , Ww          , Ww          , Ww          , Ww          , Ww          , Gg          , Gg          , Ww          , Gs^Fp       , Gs^Fp       
Ww          , Ww          , Gg          , Gg          , Re          , Gs^Fp       , Gs^Fp       , Gg          , Gs^Fp       , Hh          , Hh          , Hh          , Gg          , Gg          , Gg          , Ds          , Ww          , Ww          , Ww          , Ww          , Gg          , Gg          , Ww          , Ww          , Ww          , Ww          
Ww          , Ww          , Ww          , Re          , Gg^Ve       , Hh          , Hh          , Hh          , Hh          , Hh          , Hh          , Hh          , Ds          , Ds          , Ds          , Ds          , Ww          , Ww          , Ww          , Gg          , Gg^Vh       , Ww          , Ss          , Ss          , Ss          , Gs^Fp       
Gg          , Ww          , Ww          , Re          , Gs^Fp       , Hh          , Hh          , Hh          , Hh          , Hh          , Hh          , Ds          , Ww          , Ww          , Ww          , Ww          , Gg          , Ww          , Ss          , Ww          , Ww          , Ww          , Ss          , Ss          , Gg          , Gs^Fp       
Ww          , Ww          , Gg          , Re          , Hh          , Hh          , Mm          , Hh          , Hh          , Hh          , Ds          , Ww          , Ww          , Ww          , Ww          , Ww          , Ww          , Ss          , Ss          , Ss          , Ss          , Ss          , Ss          , Gg          , Gs^Fp       , Gs^Fp       
Gg          , Ww          , Gg          , Re          , Hh          , Hh          , Mm          , Hh          , Hh          , Hh          , Hh          , Ww          , Ww          , Ww          , Ww          , Ww          , Gg          , Ss          , Gg          , Gs^Fp       , Gs^Fp       , Gg          , Gg          , Gg          , Hh          , Hh          
Gg          , Gg          , Re          , Re          , Hh          , Hh          , Hh          , Hh          , Hh          , Hh          , Hh          , Gg          , Gg          , Gg          , Wwf         , Gg          , Gg          , Gg          , Gg          , Gg          , Gg^Ve       , Gs^Fp       , Gg          , Gs^Fp       , Hh          , Gg          
Gg          , Gg          , Re          , Gg          , Hh          , Hh          , Hh          , Hh          , Hh          , Hh          , Gg          , Gg          , Gg          , Gg          , Wwf         , Gg          , Gg          , Gg          , Gg          , Gg          , Gs^Fp       , Gs^Fp       , Gs^Fp       , Gg          , Gg          , Gg          
Gg          , Gg          , Re          , Gg          , Hh          , Hh          , Hh          , Hh          , Hh          , Gg          , Gs^Fp       , Gg          , Gg          , Gg          , Wwf         , Gg          , Gg          , Gg          , Gg          , Gg          , Gg          , Gg          , Gs^Fp       , Gs^Fp       , Gg          , Gg          
Gg          , Gg          , Re          , Gg          , Gg          , Hh          , Hh          , Gg          , Gs^Fp       , Gs^Fp       , Gs^Fp       , Gg          , Gg^Vh       , Ww          , Gg          , Gg          , Gg          , Gg          , Gg          , Gg          , Gg          , Gg          , Gg          , Gg^Ve       , Gg          , Gg          
Gg          , Gg          , Gg          , Re          , Re          , Gg          , Gg          , Gg          , Gs^Fp       , Gs^Fp       , Gs^Fp       , Gg          , Ww          , Ww          , Gg          , Gg          , Gg          , Gg          , Gg          , Gg          , Gg          , Gg          , Gg          , Gg          , Gg          , Gg          
Gg          , Gg          , Gg          , Gg^Vh       , Re          , Re          , Re          , Gg          , Gs^Fp       , Gs^Fp       , Gs^Fp       , Gg          , Ww          , Ww          , Ww          , Gg          , Gg          , Gg          , Gg          , Gg          , Gg          , Gg          , Gg          , Gg          , Gg          , Gg          
Gg          , Gg          , Re          , Re          , Gg          , Gg          , Re          , Gg          , Gg          , Gs^Fp       , Gs^Fp       , Gg          , Ww          , Ww          , Ww          , Gg          , Gg          , Gg          , Gg          , Gg          , Gg          , Gg          , Gg          , Gg          , Gg          , Gg          
Gg          , Re          , Gg          , Gg          , Gg          , Gg          , Re          , Re          , Re          , Gg          , Gs^Fp       , Gs^Fp       , Wwf         , Ww          , Ss          , Ss          , Gg          , Gg          , Gg          , Gg          , Gg          , Gg          , Gg          , Gg          , Gg          , Gs^Fp       
Re          , Re          , Gg          , Gg          , Gg          , Ww          , Re          , Gg          , Gg          , Re          , Gs^Fp       , Gs^Fp       , Ww          , Gg          , Ss          , Ss          , Gg          , Gg          , Re          , Gg          , Gg          , Gg          , Gs^Fp       , Gs^Fp       , Gs^Fp       , Gs^Fp       
Re          , Gg          , Ww          , Ww          , Hh          , Re          , Gg^Vh       , Gg          , Gg          , Re          , Re          , Gg          , Ww^Bw/      , Re          , Re          , Re          , Re          , Re          , Gg          , Re          , Re          , Gg          , Gs^Fp       , Gg          , Gg          , Gs^Fp       
Gg          , Hh          , Ww          , Ww          , Hh          , Re          , Gg          , Gg          , Gg          , Gg          , Gg          , Re          , Wwf         , Gs^Fp       , Gg          , Gg          , Gg          , Gg          , Gg          , Gg          , Re          , Gg^Vh       , Gs^Fp       , Gs^Fp       , Re          , Gs^Fp       
Gg          , Hh          , Hh          , Mm          , Hh          , Re          , Re          , Gg          , Gg          , Gg          , Gg          , Gg^Vh       , Ww          , Gs^Fp       , Gg          , Gg          , Gg          , Gg          , Hh^Fp       , Hh^Fp       , Hh^Fp       , Re          , Re          , Re          , Gs^Fp       , Re          
Hh          , Ds          , Ds          , Hh          , Hh          , Gg          , Gg          , Re          , Re          , Gg          , Gg          , Ww          , Ww          , Gg          , Gg          , Gg          , Gg          , Hh^Fp       , Hh^Fp       , Hh^Fp       , Hh^Fp       , Hh^Fp       , Gg          , Gg          , Gg          , Re          
Ww          , Ww          , Ww          , Ds          , Ds          , Gg          , Gg          , Ww          , Ds          , Ww^Bw\      , Ww          , Wwf         , Gg          , Gg          , Gg          , Gg          , Gg          , Hh^Fp       , Hh^Fp       , Hh^Fp       , Hh^Fp       , Hh^Fp       , Gg          , Gg          , Gg          , Gg          
Ww          , Ww          , Ww          , Ww          , Ds          , Gg          , Gg          , Ds          , Ww          , Ww^Bw|      , Ww          , Gg          , Gg          , Gg          , Gg          , Gg          , Hh          , Hh^Fp       , Hh^Fp       , Hh^Fp       , Hh^Fp       , Hh^Fp       , Hh^Fds      , Hh^Fds      , Hh^Fds      , Hh^Fds      
Ww          , Ww          , Ww          , Ww          , Ww          , Ds          , Gg          , Ds          , Ww          , Ww^Bw|      , Ww          , Gg          , Gg          , Gg          , Hh          , Hh          , Hh^Fp       , Hh^Fp       , Hh^Fp       , Hh^Fp       , Hh^Fp       , Hh          , Gg          , Gg          , Hh^Fds      , Re          
Ww          , Ww          , Ww          , Ww          , Ww          , Ds          , Ds          , Ds          , Ww          , Re          , Gg^Vh       , Hh          , Hh          , Hh          , Hh          , Mm          , Mm          , Mm          , Hh^Fp       , Hh^Fp       , Hh          , Hh          , Hh^Vhh      , Gg          , Gg          , Re          
Ww          , Ww          , Ww          , Ww          , Ww          , Ww          , Ww          , Ww          , Re          , Re          , Hh          , Hh          , Hh          , Mm          , Mm          , Mm          , Mm          , Ch          , Ch          , Mm          , Mm          , Hh          , Hh          , Gg          , Gg^Vh       , Re          
Gg          , Re          , Re          , Ww          , Ww          , Ww          , Re          , Gg          , Re          , Hh          , Hh          , Mm          , Mm          , Mm          , Mm          , Mm          , Mm          , Mm          , Ch          , Ch          , Ch          , Mm          , Hh          , Hh          , Gg          , Re          
Gg          , Gg          , Gg          , Re          , Re          , Ww^Bw/      , Gg^Vh       , Re          , Re          , Gg          , Hh          , Hh          , Mm          , Mm          , Mm          , Mm          , Mm          , Mm          , Ch          , 4 Kh        , Ch          , Mm          , Mm          , Hh          , Hh          , Re          
Gg          , Gg          , Gg          , Gs^Fp       , Ww          , Ww          , Gg          , Gs^Fp       , Re          , Gg          , Gg          , Hh          , Hh          , Mm          , Mm          , Mm          , Mm          , Mm          , Mm          , Ch          , Mm          , Mm          , Hh          , Hh          , Hh          , Re          
Gg          , Gg          , Gg          , Ww          , Gs^Fp       , Gs^Fp       , Gs^Fp       , Gs^Fp       , Re          , Gs^Fp       , Gs^Fp       , Gs^Fp       , Hh          , Mm          , Mm          , Mm          , Mm          , Mm          , Mm          , Mm          , Mm          , Mm          , Mm          , Mm          , Hh          , Re          
Gg          , Gg          , Gs^Fp       , Ww          , Gg          , Gs^Fp       , Gg          , Gg          , Gs^Fp       , Ch          , Ch          , Ch          , Gs^Fp       , Hh          , Mm          , Mm          , Mm          , Mm          , Mm          , Mm          , Mm          , Mm          , Mm          , Hh          , Hh          , Re          
Gg          , Gg          , Gs^Fp       , Ww          , Gg          , Gs^Fp       , Gs^Fp       , Gs^Fp       , Gs^Fp       , Ch          , 3 Kh        , Ch          , Gg^Ve       , Hh          , Mm          , Mm          , Mm          , Mm          , Ww          , Ww          , Ww          , Mm          , Mm          , Hh          , Hh          , Re          
Gg          , Gg          , Ww          , Ww          , Gs^Fp       , Gs^Fp       , Gg^Ve       , Gs^Fp       , Gg          , Ch          , Ch          , Gs^Fp       , Gg          , Hh          , Hh          , Mm          , Mm          , Ww          , Ww          , Ww          , Ww          , Mm          , Mm          , Hh          , Ww          , Ww^Bw|      
Gs^Fp       , Gs^Fp       , Ww          , Gg          , Gg          , Gs^Fp       , Gs^Fp       , Gs^Fp       , Gg          , Gg          , Gg          , Gg          , Gg          , Hh^Fds      , Hh^Fds      , Hh^Fds      , Ww          , Hh^Fds      , Ww          , Ww          , Mm          , Mm          , Hh          , Hh          , Ww          , Re          
Gs^Fp       , Gs^Fp       , Ww          , Gg          , Gs^Fp       , Gs^Fp       , Gs^Fp       , Gs^Fp       , Gg          , Gg          , Gg          , Gg          , Hh^Fds      , Hh^Fds      , Hh^Fp       , Hh          , Hh^Fds      , Hh^Fds      , Ww          , Ww          , Hh          , Hh          , Ww          , Ww          , Gg          , Gg          
Gs^Fp       , Gs^Fp       , Ww          , Gg          , Gg          , Gs^Fp       , Gs^Fp       , Gs^Fp       , Gg          , Gg          , Gg          , Gg          , Hh^Fds      , Hh^Fp       , Hh^Fds      , Hh^Fds      , Hh^Fds      , Hh^Fds      , Hh^Fds      , Ww          , Ww          , Ww          , Gs^Fp       , Gs^Fp       , Gg          , Gg          
Ww          , Gs^Fp       , Ww          , Gs^Fp       , Gg          , Gs^Fp       , Gs^Fp       , Gg          , Gg          , Hh^Fds      , Hh^Fds      , Hh^Fds      , Hh^Fds      , Hh^Fds      , Hh^Fds      , Hh^Fds      , Hh^Fds      , Ww          , Ww          , Ww          , Gg          , Gg          , Gg          , Gg          , Gg          , Gg          
