border_size=1
usage=map

Ql          , Ql          , Ql          , Ql          , Ql          , Ql          , Ql          , Ql          , Ql          , Ql          , Ql          , Qxu         , Qxu         , Qxu         , Qxu         , Qxu         , Qxu         , Xos         , Xos         , Rr          , Rr          , Rr          , Rr          , Rr          , Cud         , Cud         , Cud         , Rr          , Rr          , Rr          , Rr          , Cud         , Cud         , Cud         , Cud         , Cud         , Cud         
Ql          , Ql          , Ql          , Ql          , Ql          , Ql          , Ql          , Ql          , Ql          , Ql          , Ql          , Qxu         , Ql          , Qxu         , Qxu         , Qxu         , Qxu         , Uu          , Uu          , Xos         , Xos         , Rr          , Rr          , Rr          , Cud         , Cud         , Cud         , Rr          , Rr          , Rr          , Uu^Vud      , Rr          , Rr          , Cud         , 2 Kud       , Cud         , Cud         
Xu          , Ql          , Xu          , Ql          , Qlf         , Xu          , Xu          , Xu          , Xu          , Ql          , Ql          , Ql          , Ql          , Qxu         , Qxu         , Qxu         , Qxu         , Qxu         , Uu          , Uu          , Uu          , Xos         , Cud         , Rr          , Rr          , 3 Kud       , Rr          , Rr          , Cud         , Cud         , Rr          , Rr          , Rr          , Rr          , Rr          , Cud         , Cud         
Qlf         , Xu          , Xu          , Qlf         , Qlf         , Xu          , Xu          , Xu          , Qlf         , Qlf         , Xu          , Ql          , Ql          , Ql          , Ql          , Qxu         , Qxu         , Qxu         , Qxu         , Uu          , Uu          , Ur          , Uu          , Cud         , Uu^Vud      , Rr          , Rr          , Uu^Vud      , Rr          , Rr          , Rr          , Rr          , Cud         , Uu^Vud      , Rr          , Rr          , Rr          
Qlf         , Qlf         , Qlf         , Xu          , Qlf         , Qlf         , Qlf         , Qlf         , Qlf         , Xu          , Xu          , Xu          , Ql          , Ql          , Ql          , Qxu         , Qxu         , Qxu         , Qxu         , Uu          , Uu          , Ur          , Uu          , Uu          , Uu          , Cud         , Cud         , Rr          , Rr          , Rr          , Uu^Vud      , Cud         , Rr          , Rr          , Cud         , Rr          , Rr          
Qlf         , Qlf         , Qlf         , Qlf         , Qlf         , Qlf         , Qlf         , Qlf         , Xu          , Qlf         , Xu          , Xu          , Xu          , Ql          , Ql          , Ql          , Qxu         , Qxu         , Qxu         , Qxu         , Uu          , Ur          , Uu          , Uu          , Uu          , Uu          , Uu          , Uu^Vud      , Rr          , Rr          , Rr          , Rr          , Rr          , Cud         , 4 Kud       , Cud         , Rr          
Xu          , Qlf         , Xu          , Qlf         , Xu          , Qlf         , Xu          , Xu          , Xu          , Qlf         , Xu          , Xu          , Xu          , Ql          , Qlf         , Xu          , Xu          , Qxu         , Xu          , Xu          , Xu          , Ur          , Ur          , Ur          , Ur          , Uu          , Ur          , Ur          , Ur          , Uu^Vud      , Cud         , Rr          , Rr          , Cud         , Cud         , Cud         , Rr          
Xu          , Xu          , Qlf         , Xu          , Qlf         , Xu          , Qlf         , Qlf         , Qlf         , Qlf         , Qlf         , Qlf         , Qlf         , Qlf         , Qlf         , Xu          , Qlf         , Qlf         , Xu          , Xu          , Uu          , Uu^Vud      , Uu          , Uu          , Ur          , Ur          , Ur          , Ur          , Ur          , Uu          , Uu          , Cud         , Uu^Vud      , Rr          , Rr          , Rr          , Rr          
Qlf         , Qlf         , Qlf         , Qlf         , Qlf         , Qlf         , Qlf         , Qlf         , Xu          , Qlf         , Xu          , Xu          , Qlf         , Xu          , Qlf         , Qlf         , Qlf         , Xu          , Xu          , Uu          , Uu          , Uu          , Xu          , Uu          , Ur          , Ur          , Ur          , Ur          , Ur          , Uu          , Uu          , Uu          , Uu          , Xos         , Xos         , Rr          , Rr          
Xu          , Qlf         , Xu          , Xu          , Qlf         , Qlf         , Qlf         , Xu          , Xu          , Qlf         , Xu          , Xu          , Qlf         , Xu          , Xu          , Qlf         , Qlf         , Xu          , Uu          , Uu          , Xu          , Xu          , Xu          , Xu          , Uu^Vud      , Ur          , Ur          , Ur          , Ur          , Uu          , Uu          , Uu          , Uu          , Ur          , Uu          , Xos         , Xos         
Xu          , Qlf         , Xu          , Xu          , Xu          , Qlf         , Qlf         , Xu          , Uh          , Uh          , Uh          , Qlf         , Uu          , Uu          , Uu          , Xu          , Uu          , Uu          , Xu          , Uu          , Uu          , Xu          , Xu          , Xu          , Ur          , Ur          , Xu          , Ur          , Xu          , Uu          , Uu          , Uu          , Uu          , Ur          , Uu          , Ur          , Uu^Uf       
Qlf         , Qlf         , Xu          , Xu          , Xu          , Xu          , Uh          , Uh          , Cud         , Uh          , Uh          , Qlf         , Uh          , Uh          , Uu          , Uu^Vu       , Uu          , Uu          , Xu          , Xu          , Uu          , Xu          , Xu          , Xu          , Ur          , Uu^Vud      , Xu          , Xu          , Xu          , Xu          , Xu          , Xu          , Xu          , Uu^Uf       , Xu          , Uu^Uf       , Uu^Uf       
Qlf         , Qlf         , Uh          , Xu          , Uu^Vu       , Uh          , Uh          , Cud         , 5 Kud       , Cud         , Uh          , Ql          , Ql^Bs/      , Uh          , Uh          , Uu          , Uu          , Uu          , Uh          , Xu          , Uu          , Xu          , Ur          , Ur          , Ur          , Uu          , Xu          , Xu          , Xu          , Xu          , Wwf         , Ww^Vm       , Wwf         , Wwf         , Wwf         , Wwf         , Xu          
Qlf         , Uh          , Uh          , Uh          , Uh          , Uh          , Uh          , Cud         , Cud         , Cud         , Uh          , Uh          , Uu          , Ql          , Uh          , Uu          , Uu          , Uu          , Xu          , Uh          , Uu^Uf       , Xu          , Ur          , Ur          , Ur          , Uu          , Uu          , Xu          , Xu          , Xu          , Wwf         , Wwf         , Xu          , Xu          , Xu          , Xu          , Xu          
Qlf         , Uh          , Uh          , Uh          , Uh          , Uh          , Uh          , Uu^Vu       , Uh          , Uh          , Uh          , Uh          , Uh          , Ql^Bs\      , Uu          , Uu          , Uh          , Xu          , Xu          , Xu          , Uu^Vud      , Ur          , Ur          , Ur          , Ur          , Ur          , Xu          , Uu          , Uu^Uf       , Wwf         , Xu          , Xu          , Xu          , Xu          , Xu          , Xu          , Xu          
Qlf         , Uh          , Uu          , Uu          , Uu          , Uu          , Uu          , Uh          , Uu          , Uh          , Uu          , Uu          , Uu          , Ql          , Ql          , Uh          , Uh          , Xu          , Uu          , Uu          , Re          , Re          , Ur          , Ur          , Xu          , Wwf         , Xu          , Xu          , Xu          , Ww          , Xu          , Xu          , Xu          , Xu          , Xu          , Xu          , Xu          
Uu          , Qlf         , Xu          , Xu          , Uu          , Xu          , Xu          , Uu          , Xu          , Uu          , Xu          , Uu^Vu       , Uu          , Ql          , Ql          , Xu          , Uu          , Uu          , Re          , Re          , Uu^Uf       , Uu^Uf       , Xu          , Wwf         , Xu          , Wwf         , Wwf         , Xu          , Xu          , Ww          , Ww          , Wwf         , Wwf         , Xu          , Xu          , Xu          , Xu          
Xu          , Qlf         , Qlf         , Xu          , Uu          , Xu          , Xu          , Xu          , Xu          , Xu          , Xu          , Xu          , Xu          , Ql^Bs\      , Uu          , Uu          , Ur          , Re          , Re          , Re          , Ww          , Wwf         , Wwf         , Wwf         , Wwf         , Wwf         , Ww          , Ww          , Xu          , Xu          , Xu          , Wwf         , Ww          , Wwf         , Wwf         , Xu          , Xu          
Xu          , Xu          , Xu          , Qlf         , Uu          , Xu          , Xu          , Xu          , Xu          , Xu          , Xu          , Xu          , Xu          , Ql          , Ql          , Ql          , Ql^Bs/      , Ur          , Ur          , Xu          , Xu          , Uu          , Xu          , Ww          , Ww          , Xu          , Xu          , Ww          , Wwf         , Ww          , Wwf         , Wwf         , Xu          , Xu          , Ww          , Xu          , Xu          
Xu          , Xu          , Xu          , Uu          , Uu          , Xu          , Xu          , Xu          , Xu          , Xu          , Xu          , Xu          , Xu          , Xu          , Ur          , Ur          , Re          , Ql          , Ur          , Xu          , Uu          , Uu          , Uu          , Uu          , Uu          , Ww          , Ww          , Ww          , Wwf         , Wwf         , Xu          , Xu          , Xu          , Xu          , Ww          , Xu          , Xu          
Xu          , Xu          , Xu          , Xu          , Uu          , Xu          , Xu          , Xu          , Xu          , Xu          , Uu          , Xu          , Xu          , Xu          , Ur          , Re          , Re          , Ql^Bs/      , Ql          , Uu          , Ql          , Ql          , Ql          , Xu          , Xu          , Xu          , Xu          , Xu          , Xu          , Wwf         , Wwf         , Xu          , Xu          , Xu          , Ww          , Xu          , Xu          
Xu          , Xu          , Xu          , Xu          , Xu          , Uu          , Uu          , Uu          , Uu          , Uu          , Xu          , Uu          , Uu          , Xu          , Ur          , Re          , Xu          , Xu          , Xu          , Ql          , Ql          , Ql          , Ql          , Xu          , Xu          , Xu          , Xu          , Xu          , Xu          , Xu          , Ww          , Ww          , Ww          , Wwf         , Xu          , Xu          , Xu          
Xu          , Xu          , Xuc         , Xu          , Uu          , Uu          , Xu          , Xu          , Xu          , Xu          , Xu          , Xu          , Uu          , Uu          , Ur          , Uu^Vu       , Xu          , Xu          , Xu          , Xu          , Xu          , Ql          , Ql          , Qxu         , Xu          , Xu          , Xu          , Xu          , Qxu         , Xu          , Ww          , Xu          , Wwf         , Wwf         , Xu          , Xu          , Xu          
Xuc         , Xuc         , Xuc         , Xuc         , Xuc         , Uu          , Qxu         , Xu          , Xu          , Xu          , Xu          , Xu          , Xu          , Xu          , Ur          , Ur          , Uu          , Xu          , Xu          , Xu          , Xu          , Ql          , Ql          , Qxu         , Qxu         , Xu          , Qxu         , Qxu         , Xu          , Qxu         , Qxu         , Xu          , Wwf         , Xu          , Xu          , Xu          , Xu          
Xuc         , Xuc         , Xuc         , Xuc         , Xuc         , Xuc         , Qxu         , Qxu         , Qxu         , Xu          , Uu          , Xu          , Xu          , Xu          , Xu          , Ur          , Uu          , Uu          , Uu          , Xu          , Uu^Vu       , Ql          , Qxu         , Qxu         , Qxu         , Qxu         , Xu          , Qxu         , Xu          , Xu          , Xu          , Xu          , Wwf         , Xu          , Xu          , Xu          , Xu          
Xuc         , Xuc         , Xuc         , Xuc         , Xuc         , Xuc         , Xuc         , Xu          , Qxu         , Qxu         , Uu          , Uu          , Qxu         , Xu          , Ur          , Ur          , Ur          , Ur          , Ur          , Uu          , Uh          , Xu          , Xu          , Qxu         , Xu          , Xu          , Xu          , Xu          , Xu          , Xu          , Xu          , Xu          , Ww          , Xu          , Xu          , Xu          , Xu          
Xuc         , Xuc         , Xuc         , Xuc         , Xuc         , Xuc         , Xuc         , Xu          , Xu          , Qxu         , Qxu         , Qxu         , Ur          , Qxu^Bs/     , Qxu         , Ur          , Xu          , Xu          , Ur          , Uh          , Uh          , Xu          , Xu          , Xu          , Xu          , Xu          , Xu          , Xu          , Xu          , Xu          , Xu          , Xu          , Ww          , Ww          , Ww          , Xu          , Xu          
Xuc         , Xuc         , Xuc         , Xuc         , Xuc         , Xuc         , Xuc         , Xuc         , Xuc         , Xu          , Uu          , Ur          , Uu          , Qxu         , Qxu         , Qxu^Bs|     , Qxu         , Ur          , Ww          , Xu          , Xu          , Xu          , Xu          , Xu          , Xu          , Xu          , Xu          , Xu          , Xu          , Xu          , Xu          , Ww          , Xu          , Xu          , Ww          , Xu          , Xu          
Xuc         , Xuc         , Xuc         , Xuc         , Xuc         , Xuc         , Xuc         , Xuc         , Xu          , Uu          , Uu          , Ur          , Uu          , Qxu         , Uu          , Uu          , Qxu         , Uu          , Xu          , Ww          , Ww          , Xu          , Xu          , Xu          , Ww          , Ww          , Ww          , Ww          , Ww          , Xu          , Ww          , Ww          , Xu          , Ww          , Xu          , Xu          , Xu          
Xuc         , Xuc         , Xu          , Xu          , Xu          , Xuc         , Uh          , Uh          , Uh          , Uh          , Uu          , Ur          , Ur          , Uu          , Uu          , Qxu         , Xu          , Uu          , Qxu         , Ww          , Xu          , Ww          , Ww          , Ww          , Xu          , Xu          , Xu          , Xu          , Xu          , Ww          , Xu          , Ww          , Xu          , Wwf         , Xu          , Xu          , Xu          
Xu          , Xu          , Uu          , Uu^Vud      , Uu          , Xu          , Uh          , Uu          , Uu          , Uu          , Ur          , Ur          , Xu          , Xu          , Uu          , Qxu         , Qxu         , Qxu         , Uu          , Qxu         , Uu          , Ww          , Xu          , Ww          , Ww          , Xu          , Ww          , Ww          , Xu          , Ww          , Ww          , Xu          , Wwf         , Wwf         , Xu          , Xu          , Xu          
Xu          , Uu          , Uu          , Uu          , Uu          , Uu          , Uu          , Uu          , Ur          , Ur          , Xu          , Xu          , Xu          , Xu          , Xu          , Uu          , Uu          , Uu          , Qxu         , Uu          , Uu          , Xu          , Xu          , Ww          , Ww          , Xu          , Xu          , Ww          , Ww          , Ww          , Ww          , Wwf         , Ww          , Xu          , Ww          , Xu          , Ww          
Xu          , Uu^Vud      , Uu          , Uu          , Cud         , Uu          , Ur          , Ur          , Xu          , Xu          , Xu          , Xu          , Xu          , Xu          , Xu          , Xu          , Xu          , Uu          , Uu^Uf       , Qxu         , Xu          , Ww          , Ww          , Xu          , Wwf         , Xu          , Wwf         , Ww          , Ww          , Xu          , Ww          , Ww          , Ww          , Ww          , Ww          , Ww          , Ww          
Xu          , Uu          , Uu          , Cud         , 1 Kud       , Cud         , Uu          , Uu^Vud      , Xu          , Xu          , Xu          , Xu          , Xu          , Xu          , Xu          , Xu          , Xu          , Xu          , Wwf         , Uu^Uf       , Ww          , Ww          , Ww          , Wwf         , Xu          , Wwf         , Xu          , Ww          , Wwf         , Xu          , Ww          , Ww          , Wo          , Wo          , Wo          , Wo          , Wo          
Xu          , Uu          , Ur          , Cud         , Cud         , Cud         , Uu          , Uu^Uf       , Wwf         , Xu          , Wwf         , Xu          , Ww          , Xu          , Ww          , Xu          , Wwf         , Wwf         , Wwf         , Ww          , Xu          , Xu          , Xu          , Xu          , Xu          , Xu          , Xu          , Xu          , Xu          , Ww          , Ww          , Wo          , Wo          , Wo          , Wo          , Wo          , Wo          
Xu          , Ur          , Uu^Vud      , Uu          , Uu          , Uu          , Uu^Uf       , Uu^Uf       , Ww          , Wwf         , Xu          , Ww          , Xu          , Ww          , Xu          , Ww          , Xu          , Ww          , Xu          , Xu          , Xu          , Xu          , Xu          , Xu          , Xu          , Xu          , Xu          , Xu          , Xu          , Ww          , Ww          , Wo          , Wo          , Wo          , Wo          , Wo          , Wo          
Xu          , Ur          , Xu          , Uu          , Xu          , Uu          , Xu          , Xu          , Ww          , Xu          , Xu          , Xu          , Xu          , Xu          , Xu          , Xu          , Xu          , Xu          , Xu          , Xu          , Xu          , Xu          , Xu          , Xu          , Xu          , Xu          , Xu          , Xu          , Xu          , Ww          , Ww          , Wo          , Wo          , Wo          , Wo          , Wo          , Wo          
