border_size=1
usage=map

Xu          , Xu          , Xu          , Xu          , Xu          , Xu          , Ur          , Xu          , Xu          , Xu          , Xu          , Xu          
Xu          , Xu          , Uu          , Xu          , Xu          , Xu          , Ur          , Xu          , Xu          , Xu          , Xu          , Xu          
Xu          , Uh          , Uh          , Uu          , Uu          , Xu          , Xu          , Xu          , Uu^Vu       , Xu          , Xu          , Xu          
Xu          , Uh          , Uh          , Uh          , Uh          , Uu          , Ur          , Xu          , Ur          , Ur          , Ur          , Xu          
Xu          , Uh          , Uh          , Uh          , Xu          , Xu          , Xu          , Xu          , Xu          , Ur          , Qxu         , Qxu         
Xu          , Uh          , Xu          , Xu          , Xu          , Xu          , Xu          , Xu          , Uh          , Uh          , Qxu         , Qxu         
Xu          , Xu          , Qxu         , Qxu         , Qxu         , Qxu         , Qxu         , Uu^Vu       , Uh          , Xu          , Xu          , Qxu         
Xu          , Qxu         , Qxu         , Qxu         , Qxu         , Qxu         , Ur          , Qxu^Bs/     , Qxu         , Uu          , Uu^Uf       , Xu          
Xu          , Qxu         , Qxu^Bs/     , Ur          , Qxu^Bs\     , Ur          , Ur          , Ur          , Qxu         , Qxu         , Qxu         , Xu          
Xu          , Ur          , Qxu         , Qxu         , Xu          , Ur          , Xu          , Ur          , Qxu         , Qxu         , Qxu         , Xu          
Xu          , Ur          , Xu          , Xu          , Xu          , Xu          , Xu          , Xu          , Xu          , Qxu         , Qxu         , Xu          
Xu          , Ur          , Xu          , Xu          , Uu^Vu       , Xu          , Xu          , Xu          , Xu          , Xu          , Xu          , Xu          
Xu          , Ur          , Xu          , Xu          , Wwf         , Ur          , Ur          , Xu          , Ww          , Xu          , Xu          , Xu          
Wo          , Wo          , Wo          , Ww          , Xu          , Ww          , Ww          , Wwf         , Ww          , Wwf         , Wwf         , Ww          
Xu          , Xu          , Xu          , Xu          , Xu          , Xu          , Xu          , Xu          , Xu          , Wwf         , Ww          , Ww          
Qlf         , Qlf         , Qlf         , Qlf         , Ql          , Xu          , Xu          , Xu          , Xu          , Wwf         , Xu          , Ww          
Xu          , Xu          , Xu          , Xu          , Ql          , Ql          , Xu          , Xu          , Xu          , Wwf         , Ww^Xo       , Xu          
Ql          , Uu^Vu       , Ql^Bs\      , Ql          , Ql          , Ql          , Ql          , Ql          , Ql^Bs/      , Ur          , Ql          , Ql          
Ql          , Ql^Bs|      , Ql          , Ur          , Ql^Bs\      , Ql          , Ql^Bs/      , Uu^Vu       , Ql          , Ql          , Ql          , Ql          
Xu          , Ql^Bs|      , Ql          , Ql          , Ql          , Uu^Vu       , Ql          , Ql          , Ql          , Ql          , Ql          , Xu          
Xu          , Uu^Vu       , Xu          , Xu          , Xu          , Xu          , Xu          , Xu          , Xu          , Ql          , Xu          , Xu          
Xu          , Xu          , Ur          , Xu          , Ur          , Xu          , Xu          , Xu          , Xu          , Xu          , Xu          , Xu          
Xu          , Xu          , Xu          , Ur          , Xu          , Ur          , 1 Ur        , Xu          , Xu          , Xu          , Xu          , Xu          
Xu          , Xu          , Xu          , Xu          , Xu          , Xu          , Ur          , Xu          , Xu          , Xu          , Xu          , Xu          
