border_size=1
usage=map

Chs         , Chs         , Chs         , Chs         , Chs         , Ss          , Ss          , Ss          , Ss          , Ss          , Ww          , Ww          , Ss          , Ss          , Ww          , Ww          , Ww          , Gg          , Gs^Fds      , Gs^Fds      , Gs^Fds      , Gs^Fds      , Gs^Fds      , Ww          , Gs^Fds      , Gs^Fds      , Gs^Fds      , Gs^Fds      , Gs^Fds      , Gs^Fds      , Ss          , Gs^Fds      
Chs         , Chs         , 3 Khs       , Chs         , Ww          , Ww          , Ww          , Ss          , Ww          , Ww          , Ww          , Ss          , Ss          , Ss          , Ww          , Ww          , Ww          , Gg          , Gs^Fds      , Gs^Fds      , Rd          , Ss^Vhs      , Ww          , Ww          , Gs^Fds      , Ss^Vhs      , Gs^Fds      , Chr         , Gs^Fds      , Ss          , Gs^Fds      , Gs^Fds      
Chs         , Chs         , Chs         , Chs         , Ww          , Ss^Vhs      , Ss          , Ww          , Ss          , Ww          , Ww          , Ss^Vhs      , Ww          , Ww          , Ww          , Gg          , Ss          , Ww          , Ww          , Gs^Fds      , Ww          , Wwf         , Rd          , Ss          , Ss          , Rd          , Gs^Fds      , Chr         , 4 Kh        , Gs^Fds      , Chr         , Gs^Fds      
Chs         , Chs         , Ss          , Ww          , Ww          , Ss          , Ss          , Ss          , Ss          , Ww          , Gg          , Ww          , Gg          , Ww          , Gg          , Gg          , Ss          , Gs^Fds      , Ss          , Ww          , Ss          , Gs^Fds      , Gs^Fds      , Ss          , Gs^Fds      , Ss          , Gs^Fds      , Chr         , Chr         , Chr         , Ss          , Ss          
Ww          , Ww          , Ww          , Ww          , Ss          , Ss          , Ss          , Ss          , Ww          , Ww          , Gg          , Ww          , Gg          , Gg          , Gg          , Gg          , Gs^Fds      , Ss          , Gg          , Ss          , Gs^Fds      , Ss          , Ss          , Ss          , Ss          , Ss          , Ss          , Chr         , Gs^Fds      , Ss          , Ss          , Gs^Fds      
Ww          , Ss^Vhs      , Ww          , Ss          , Ss          , Ss          , Gg          , Ww          , Ss          , Ss          , Gg          , Ww          , Ww          , Gg          , Gg          , Gs^Fds      , Gs^Fds      , Gs^Fds      , Gg          , Gg          , Gs^Fds      , Ss          , Ss          , Ss          , Ss          , Gs^Fds      , Gs^Fds      , Rd          , Ss          , Ss          , Gs^Fds      , Gs^Fds      
Ss          , Ss          , Ww          , Ss          , Ss          , Gg          , Ss^Vhs      , Ss          , Gg          , Gg          , Gg          , Gg          , Ww          , Gg          , Gg          , Gg          , Gg          , Gg          , Gs^Fds      , Gs^Fds      , Gs^Fds      , Gs^Fds      , Gg          , Ss          , Ss          , Ss          , Gg^Fet      , Ss          , Gs^Fds      , Gs^Fds      , Gs^Fds      , Gs^Fds      
Ss          , Ss          , Ww          , Gg          , Ss          , Ss          , Ss          , Ss          , Re^Gvs      , Re^Gvs      , Gg          , Gg          , Ww          , Gg          , Gg          , Gg          , Gg          , Gs^Fds      , Gs^Fds      , Gs^Fds      , Gs^Fds      , Gg          , Gg          , Gs^Fds      , Ss          , Gs^Fds      , Gs^Fds      , Ss          , Ss^Vhs      , Gg^Fet      , Gs^Fds      , Gs^Fds      
Ss          , Ss          , Ww          , Gg          , Ss          , Gg          , Gg          , Re^Gvs      , Re^Gvs      , Re^Gvs      , Gg          , Ww          , Gg          , Gg          , Gg          , Gg          , Gg          , Gg          , Gg^Vh       , Gs^Fds      , Gs^Fds      , Gg          , Gg          , Gs^Fds      , Gs^Fds      , Ss          , Ss          , Ss          , Rd          , Gs^Fds      , Gs^Fds      , Gs^Fds      
Ss          , Gg          , Ss          , Ww          , Gg          , Gg          , Gg          , Re^Gvs      , Re^Gvs      , Re^Gvs      , Gg          , Ww          , Gg          , Gg          , Gg          , Gg          , Gg          , Gg          , Gg          , Gs^Fds      , Gg          , Gg          , Gg          , Gs^Fds      , Gs^Fds      , Gs^Fds      , Gs^Fds      , Gs^Fds      , Rd          , Gs^Fds      , Gs^Fds      , Gs^Fds      
Gg          , Ss          , Gg          , Ww          , Ww          , Gg          , Gg          , Re^Gvs      , Re^Gvs      , Re^Gvs      , Ww          , Ww          , Gg          , Gg          , Gg          , Gg          , Gg          , Gg          , Gg          , Gg          , Gg          , Gg          , Gg          , Gg          , Gg          , Gs^Fds      , Gs^Fds      , Gs^Fds      , Rd          , Gg^Fet      , Gg^Ve       , Gs^Fds      
Gg          , Gg          , Gg          , Ww          , Ww          , Gg          , Gg          , Gg^Vh       , Gg          , Gg          , Ww          , Gg          , Gg          , Gg          , Mm^Xm       , Gg          , Mm^Xm       , Gg          , Gg          , Gg          , Gg          , Gg          , Gg          , Gg          , Gg          , Gs^Fds      , Gs^Fds      , Gs^Fds      , Rd          , Rd          , Gs^Fds      , Gs^Fds      
Gg          , Gg          , Gg          , Ww          , Gg          , Gg          , Gg          , Gg          , Ww          , Ww^Bw\      , Gg          , Gg          , Mm^Xm       , Gg          , Ch          , Kh          , Ch          , Gg          , Mm^Xm       , Gg          , Gg          , Gg          , Gg          , Gg          , Gg          , Gg          , Rd          , Rd          , Gs^Fds      , Gs^Fds      , Gs^Fds      , Gs^Fds      
Gg          , Gg          , Gg          , Ww          , Ww          , Gg          , Gg          , Gg          , Ww          , Gg          , Gg          , Gg          , Kh          , Ch          , Co          , Co          , Co          , Ch          , Kh          , Gg          , Gg          , Gg          , Gg          , Gg          , Gg          , Gg          , Gs^Fds      , Gs^Fds      , Gs^Fds      , Gs^Fds      , Gs^Fds      , Gs^Fds      
Gg          , Gg          , Gg          , Ww          , Ww          , Gg          , Ww          , Ww          , Gg          , Gg          , Gg          , Mm^Xm       , Ch          , Co          , Ch          , Ch          , Ch          , Co          , Ch          , Mm^Xm       , Gg          , Gg          , Gg          , Gg          , Gg          , Gg          , Gs^Fds      , Gs^Fds      , Gg          , Gs^Fds      , Gs^Fds      , Gs^Fds      
Gg          , Gg          , Gg          , Ww          , Gg          , Ww          , Ww          , Gg          , Gg          , Gg          , Gg          , Gg          , Ch          , Co          , Ch          , Kh          , Ch          , Co          , Ch          , Gg          , Gg          , Gg          , Gg          , Gg          , Gg          , Gg          , Gg          , Gg          , Gg          , Gs^Fds      , Gs^Fds      , Gs^Fds      
Gg          , Gg          , Ww          , Ww          , Gg          , Ww          , Ww          , Gg          , Gg          , Gg          , Gg          , Mm^Xm       , 2 Kh        , Co          , Co          , Ch          , Co          , Co          , Kh          , Mm^Xm       , Gg          , Gg          , Gg          , Gg          , Gg          , Gg          , Gg          , Gg          , Gg          , Gg          , Gg          , Gs^Fds      
Gg          , Ww          , Ww          , Gg          , Gg          , Gg          , Gg          , Ww          , Ww          , Gg          , Gg          , Gg          , Mm^Xm       , Ch          , Ch          , Co          , Ch          , Ch          , Mm^Xm       , Gg          , Gg          , Gg          , Gg          , Gg          , Gg          , Gg          , Gs^Fds      , Gg          , Gg          , Gg          , Gg          , Gg          
Ww          , Ww          , Ww          , Gg          , Ww          , Ww          , Ww          , Ww          , Gg          , Gg          , Gg          , Gg          , Gg          , Rd          , Mm^Xm       , Kh          , Mm^Xm       , Gg          , Gg          , Gg          , Gg          , Gg          , Gg          , Gg          , Gg          , Gs^Fds      , Hh^Fms      , Gs^Fds      , Gs^Fds      , Gg          , Hh          , Hh          
Gg          , Gg          , Ww          , Ww          , Gg          , Ww          , Gg          , Gg          , Gg          , Gg          , Gg          , Gg          , Rd          , Rd          , Gg          , Gg          , Gg          , Gg          , Gg          , Gg          , Gg          , Gg          , Gg          , Gg          , Hh^Fms      , Gs^Fds      , Hh^Fms      , Hh^Fms      , Hh^Fms      , Hh^Fms      , Hh          , Hh          
Gg          , Gg          , Ww          , Gg          , Gg          , Gg          , Gg          , Gg          , Gg          , Gg          , Rd          , Rd          , Re^Gvs      , Gg          , Gg          , Gg          , Gg          , Gg          , Gg          , Gs^Fds      , Gs^Fds      , Gg          , Gg          , Gg          , Hh^Fms      , Hh^Fms      , Hh^Fms      , Hh^Fms      , Hh          , Hh          , Hh          , Mm          
Gg          , Gg          , Ww          , Ww          , Gg          , Gg          , Gg          , Gg          , Rd          , Rd          , Re^Gvs      , Re^Gvs      , Re^Gvs      , Gg          , Gg          , Gg          , Gg          , Gg          , Gg          , Gs^Fds      , Hh^Fms      , Gs^Fds      , Gs^Fds      , Gg          , Hh          , Hh^Fms      , Mm          , Mm          , Mm          , Hh          , Mm          , Mm          
Gg          , Gg          , Ww          , Ww          , Hh          , Gg          , Hh          , Gg          , Rd          , Re^Gvs      , Gg^Vh       , Re^Gvs      , Re^Gvs      , Gg          , Gg          , Gg          , Gg          , Gg          , Gg          , Hh^Fms      , Hh^Fms      , Gs^Fds      , Gg          , Gg          , Hh          , Mm          , Mm          , Mm          , Mm          , Mm          , Mm          , Mm          
Ww          , Ww          , Hh          , Gg          , Hh          , Hh          , Hh^Fms      , Hh^Fms      , Rd          , Re^Gvs      , Re^Gvs      , Re^Gvs      , Re^Gvs      , Gg          , Gg          , Gg          , Gs^Fds      , Gg          , Hh^Fms      , Hh^Fms      , Hh^Fms      , Gs^Fds      , Gg          , Gg          , Hh          , Mm          , Mm          , Mm          , Mm          , Mm          , Mm          , Mm          
Gg          , Hh          , Hh          , Hh          , Hh          , Hh^Fms      , Hh^Fms      , Hh          , Rd          , Re^Gvs      , Re^Gvs      , Re^Gvs      , Gg          , Gg          , Gg          , Gg          , Gs^Fds      , Gg          , Gg          , Hh^Fms      , Hh^Fms      , Hh^Fms      , Hh          , Hh          , Mm          , Mm          , Mm          , Mm          , Mm          , Mm          , Mm          , Mm          
Hh          , Hh          , Gg          , Gg          , Hh          , Hh^Fms      , Hh          , Gg          , Gg          , Rd          , Gg          , Gg          , Gg          , Gg          , Gs^Fds      , Gs^Fds      , Gs^Fds      , Gg          , Hh^Fms      , Gg          , Hh          , Mm          , Mm          , Mm          , Mm          , Mm          , Mm          , Mm^Vhh      , Mm          , Mm          , Mm^Xm       , Mm^Xm       
Hh          , Hh          , Gg          , Hh          , Hh          , Hh^Fms      , Hh          , Gg          , Rr          , Rd          , Gg          , Gg          , Gg          , Gs^Fds      , Hh^Fms      , Hh^Fms      , Hh^Fms      , Hh^Fms      , Hh          , Hh^Fms      , Hh          , Hh          , Mm          , Mm          , Mm          , Mm          , Mm          , Mm          , Mm          , Mm          , Mm^Xm       , Mm^Xm       
Hh          , Hh          , Gg          , Hh          , Hh          , Hh          , Rp          , Rp^Vhc      , Rr          , Rr          , Rr          , Gg          , Gg          , Hh^Fms      , Hh^Fms      , Hh          , Hh          , Hh          , Hh          , Hh          , Mm          , Mm          , Mm          , Mm          , Mm^Vhh      , Mm          , Mm          , Mm          , Mm          , Mm          , Mm^Xm       , Mm^Xm       
Hh          , Hh^Fms      , Hh          , Gg          , Hh          , Rp^Vhc      , Rr          , Rr          , Rp          , Rp^Vhc      , Rr          , Rp^Vhc      , Gg          , Hh^Fms      , Hh^Fms      , Hh          , Mm          , Mm          , Mm          , Mm          , Mm          , Mm          , Hh          , Mm          , Mm          , Mm          , Mm          , Mm          , Mm          , Mm          , Mm^Xm       , Mm^Xm       
Hh          , Hh^Fms      , Hh^Fms      , Hh^Fms      , Hh          , Rr          , Rr          , Rp^Vhc      , Rr          , Rr          , Rp^Vhc      , Gg          , Hh          , Hh          , Mm          , Mm^Vhh      , Mm          , Mm          , Mm          , Mm          , Mm          , Mm          , Gg          , Hh          , Mm          , Mm          , Mm          , Mm          , Mm          , Mm^Vhh      , Mm^Xm       , Mm^Xm       
Hh          , Hh^Fms      , Hh^Fms      , Gg          , Hh^Fms      , Gg          , Gg          , Rr          , Rp^Vhc      , Gg          , Gg          , Gg          , Hh          , Hh          , Mm          , Mm          , Mm          , Mm          , Hh          , Mm          , Hh          , Mm          , Mm          , Gg          , Mm          , Mm          , Mm          , Mm          , Mm          , Mm          , Mm^Xm       , Mm^Xm       
Hh          , Hh          , Hh          , Hh^Fms      , Hh          , Hh^Fms      , Hh          , Rd          , Gg          , Gg          , Hh          , Hh          , Hh          , Hh          , Mm          , Mm          , Mm          , Mm          , Mm          , Gg          , Mm          , Mm          , Mm          , Hh          , Mm          , Mm          , Mm          , Mm          , Mm^Xm       , Mm^Xm       , Mm          , Mm^Xm       
Gg          , Gg          , Gg          , Gg          , Gg          , Gg          , Gg          , Rd          , Gg          , Gg          , Gg          , Gg          , Gg          , Gg          , Gg          , Gg          , Hh          , Mm          , Hh          , Mm          , Gg          , Mm          , Hh^Fds      , Mm          , Mm          , Mm          , Hh          , Mm          , Mm          , Mm          , Mm          , Mm          
Gg          , Gg          , Gg          , Gg          , Gg          , Gg          , Gg          , Rd          , Gg          , Gg          , Gs^Fds      , Gg          , Gg          , Gg          , Gg          , Gg          , Gg          , Hh          , Mm          , Gg          , Mm          , Gg          , Hh^Fds      , Hh          , Gg          , Mm          , Mm          , Mm          , Mm          , Mm          , Mm          , Mm          
Gs^Fds      , Gs^Fds      , Gg          , Gg          , Gg          , Gg          , Gg          , Rd          , Gg          , Gg          , Gg          , Gg          , Re^Gvs      , Re^Gvs      , Re^Gvs      , Gg          , Gg          , Mm          , Mm          , Mm          , Mm          , Mm          , Hh          , Hh          , Mm          , Mm          , Mm          , Gg          , Hh          , Mm          , Mm          , Mm          
Gg          , Gs^Fds      , Gs^Fds      , Gs^Fds      , Gg          , Gg          , Rd          , Rd          , Gg^Vl       , Gg          , Rr          , Gg^Vl       , Re^Gvs      , Re^Gvs      , Re^Gvs      , Gg          , Gg          , Mm          , Hh          , Mm          , Mm          , Mm          , Gg          , Mm          , Mm          , Mm          , Hh          , Hh          , Mm          , Mm          , Mm          , Mm          
Gs^Fds      , Gs^Fds      , Gg          , Gs^Fds      , Gg          , Gg          , Rd          , Rd          , Rd          , Rr          , Rr          , Gg          , Gg          , Re^Gvs      , Gg          , Gg          , Gg          , Hh          , Mm          , Hh          , Mm          , Mm          , Mm          , Gg          , Hh          , Mm          , Mm          , Mm          , Mm          , Mm          , Mm          , Mm          
Gg          , Gg          , Gg          , Gg          , Rd          , Rd          , Rd          , Gg          , Gg^Vl       , Rr          , Rd          , Gg^Vl       , Gg          , Gg          , Gg          , Gg          , Gg          , Mm          , Mm          , Mm          , Mm          , Hh          , Hh          , Hh^Fds      , Hh^Fds      , Hh          , Hh          , Hh          , Hh          , Mm          , Mm          , Mm          
Gg          , Gg          , Rd          , Rd          , Gg          , Gg          , Rd          , Gg          , Re^Gvs      , Gg          , Gg          , Rd          , Rd          , Gg          , Gg          , Gg          , Mm          , Mm          , Mm          , Mm          , Mm          , Mm          , Mm          , Hh^Fds      , Gg          , Hh          , Gg          , Gg          , Hh          , Mm          , Mm          , Mm          
Gg          , Gg          , Rd          , Gg          , Gs^Fds      , Gs^Fds      , Rd          , Re^Gvs      , Re^Gvs      , Re^Gvs      , Gg          , Gg          , Gg          , Rd          , Rd          , Gg          , Mm          , Mm          , Mm          , Mm          , Mm          , Mm          , Mm          , Hh          , Gg          , Hh          , Mm          , Mm          , Mm          , Hh          , Mm          , Mm          
Gg          , Gg          , Rd          , Gg          , Gs^Fds      , Gg          , Rd          , Re^Gvs      , Re^Gvs      , Re^Gvs      , Gg          , Gg          , Gg          , Gg          , Gg          , Rd          , Rd          , Mm          , Mm          , Mm          , Hh^Fds      , Mm          , Hh          , Hh          , Gg          , Hh^Fds      , Mm          , Mm          , Mm          , Mm          , Mm          , Mm          
Rd          , Rd          , Gg          , Gg          , Gg          , Gg          , Rd          , Gg          , Gg          , Gg          , Gg          , Gg          , Gg          , Gg          , Mm          , Mm          , Mm          , Rd          , Rd          , Hh^Fds      , Hh^Fds      , Hh^Fds      , Gg          , Gg          , Hh          , Hh          , Mm          , Mm          , Mm          , Mm          , Mm          , Mm          
Gg          , Gg          , Gg          , Gg          , Rd          , Rd          , Gg          , Gg          , Hh          , Hh          , Hh          , Hh          , Hh          , Mm          , Mm          , Mm          , Mm          , Mm          , Hh          , Rd          , Rd          , Gg          , Gg          , Gg          , Hh          , Hh          , Mm          , Mm          , Mm          , Mm          , Hh          , Hh          
Gg          , Gg          , Gg          , Gg          , Rd          , Gg          , Hh          , Hh          , Hh          , Hh          , Hh          , Hh          , Mm          , Mm          , Mm          , Mm          , Mm          , Hh^Fp       , Gg          , Gg          , Gs^Fp       , Rd          , Gg          , Gg          , Hh          , Hh          , Mm          , Mm          , Mm          , Hh          , Hh          , Hh          
Gg          , Hh          , Hh          , Gg          , Rd          , Hh          , Mm          , Mm          , Mm          , Mm          , Mm          , Hh          , Mm          , Mm          , Mm          , Mm          , Hh^Fp       , Hh^Fp       , Gg          , Gs^Fp       , Gg          , Rd          , Gg          , Gg          , Hh          , Hh          , Mm          , Mm          , Mm          , Mm          , Hh          , Hh          
Gg          , Hh          , Hh          , Hh          , Rd          , Hh          , Mm          , Mm          , Mm          , Mm          , Mm          , Hh          , Mm          , Mm          , Hh^Fp       , Hh^Fp       , Gg          , Gg          , Gg          , Gs^Fp       , Gg          , Rd          , Gg          , Gg          , Hh          , Hh          , Hh          , Mm          , Mm          , Mm          , Hh          , Hh          
Gg          , Hh          , Hh          , Hh          , Rd          , Hh          , Mm          , Mm          , Mm          , Mm          , Mm          , Hh^Fp       , Hh          , Hh^Fp       , Hh^Fp       , Gs^Fp       , Gs^Fp       , Gs^Fp       , Gs^Fp       , Gs^Fp       , Gg          , Rd          , Rd          , Gg          , Gg          , Hh          , Hh          , Mm          , Mm          , Mm          , Mm          , Hh          
Gg          , Hh          , Hh          , Hh          , Rd          , Hh          , Mm          , Mm          , Mm          , Mm          , Mm          , Mm          , Gs^Fp       , Hh          , Hh^Fp       , Gs^Fp       , Gs^Fp       , Gs^Fp       , Gs^Fp       , Gg          , Gg          , Gg          , Rd          , Gg          , Gg          , Hh          , Gg          , Hh          , Hh          , Mm          , Hh          , Hh          
Gg          , Hh          , Hh          , Hh          , Rd          , Hh          , Hh          , Mm          , Mm          , Mm          , Mm          , Mm          , Gs^Fp       , Hh^Fp       , Gs^Fp       , Gs^Fp       , Gg          , Gs^Fp       , Gs^Fp       , Gg          , Gg          , Gg          , Rd          , Gg          , Gg          , Gg          , Gg          , Hh          , Hh^Fp       , Hh          , Gg          , Hh          
Gg          , Hh          , 1 Hh        , Hh          , Rd          , Hh          , Hh          , Hh^Fp       , Mm          , Mm          , Mm          , Mm          , Gs^Fp       , Gs^Fp       , Gs^Fp       , Gs^Fp       , Gs^Fp       , Gs^Fp       , Gs^Fp       , Gs^Fp       , Gg          , Gg          , Rd          , Gs^Fp       , Gs^Fp       , Gg          , Gs^Fp       , Hh          , Hh^Fp       , Hh^Fp       , Hh^Fp       , Hh          
Gg          , Hh          , Gg          , Hh          , Rd          , Hh          , Hh^Fp       , Mm          , Mm          , Mm          , Mm          , Gs^Fp       , Gs^Fp       , Gs^Fp       , Gg          , Gg          , Gs^Fp       , Gs^Fp       , Gs^Fp       , Gg          , Gg          , Gg          , Rd          , Gg          , Gg          , Gs^Fp       , Gs^Fp       , Gs^Fp       , Gs^Fp       , Hh^Fp       , Hh^Fp       , Hh          
Gg          , Gg          , Gg          , Gg          , Hh          , Hh          , Hh          , Mm          , Mm          , Mm          , Mm          , Gs^Fp       , Gg          , Gg          , Gg          , Gg          , Gg          , Gs^Fp       , Gg          , Gs^Fp       , Gs^Fp       , Gg          , Gg          , Rd          , Gg          , Gg          , Gs^Fp       , Gs^Fp       , Gs^Fp       , Gs^Fp       , Hh          , Gg          
