border_size=1
usage=map

Chs         , Chs         , Chs         , Chs         , Chs         , Ss          , Ss          , Ss          , Ss          , Ss          , Ww          , Ww          , Ss          , Ss          , Ww          , Ww          , Ww          , Gg          , Gs^Fds      , Gs^Fds      , Gs^Fds      , Gs^Fds      , Gs^Fds      , Ww          , Gs^Fds      , Gs^Fds      , Gs^Fds      , Gs^Fds      , Gs^Fds      , Gs^Fds      , Gs^Fds      , Gs^Fds      
Chs         , Chs         , 3 Khs       , Chs         , Ww          , Ww          , Ww          , Ss          , Ww          , Ww          , Ww          , Ss          , Ss          , Ss          , Ww          , Ww          , Ww          , Gg          , Gs^Fds      , Gs^Fds      , Rd          , Gg^Ve       , Ww          , Ww          , Gs^Fds      , Gg^Ve       , Gs^Fds      , Cv          , Gs^Fds      , Gs^Fds      , Gs^Fds      , Gs^Fds      
Chs         , Chs         , Chs         , Chs         , Ww          , Ss^Vhs      , Ss          , Ww          , Ss          , Ww          , Ww          , Ss^Vhs      , Ww          , Ww          , Ww          , Gg          , Gg          , Ww          , Ww          , Gs^Fds      , Ww          , Wwf         , Rd          , Gs^Fds      , Rd          , Rd          , Gs^Fds      , Cv          , 4 Kv        , Gs^Fds      , Cv          , Gs^Fds      
Chs         , Chs         , Ss          , Ww          , Ww          , Ss          , Ss          , Ss          , Ss          , Ww          , Gg          , Ww          , Gg          , Ww          , Gg          , Gg          , Gg          , Gs^Fds      , Gs^Fds      , Ww          , Gs^Fds      , Gs^Fds      , Gs^Fds      , Rd          , Gs^Fds      , Gs^Fds      , Gs^Fds      , Cv          , Cv          , Cv          , Gs^Fds      , Gs^Fds      
Ww          , Ww          , Ww          , Ww          , Ss          , Ss          , Ss          , Ss          , Ww          , Ww          , Gg          , Ww          , Gg          , Gg          , Gg          , Gg          , Gs^Fds      , Gs^Fds      , Gg          , Gs^Fds      , Gs^Fds      , Gs^Fds      , Gs^Fds      , Gs^Fds      , Gs^Fds      , Gs^Fds      , Gs^Fds      , Cv          , Gs^Fds      , Gs^Fds      , Gs^Fds      , Gs^Fds      
Ww          , Ss^Vhs      , Ww          , Ss          , Ss          , Ss          , Gg          , Ww          , Ss          , Ss          , Gg          , Ww          , Ww          , Gg          , Gg          , Gs^Fds      , Gs^Fds      , Gs^Fds      , Gg          , Gg          , Gs^Fds      , Gs^Fds      , Gs^Fds      , Gs^Fds      , Gs^Fds      , Gs^Fds      , Gs^Fds      , Rd          , Gs^Fds      , Gs^Fds      , Gs^Fds      , Gs^Fds      
Ss          , Ss          , Ww          , Ss          , Ss          , Gg          , Ss^Vhs      , Ss          , Gg          , Gg          , Gg          , Gg          , Ww          , Gg          , Gg          , Gg          , Gg          , Gg          , Gs^Fds      , Gs^Fds      , Gs^Fds      , Gs^Fds      , Gg          , Gs^Fds      , Gs^Fds      , Gs^Fds      , Gg^Fet      , Rd          , Gs^Fds      , Gs^Fds      , Gs^Fds      , Gs^Fds      
Ss          , Ss          , Ww          , Gg          , Ss          , Ss          , Ss          , Ss          , Re^Gvs      , Re^Gvs      , Gg          , Gg          , Ww          , Gg          , Gg          , Gg          , Gg          , Gs^Fds      , Gs^Fds      , Gs^Fds      , Gs^Fds      , Gg          , Gg          , Gs^Fds      , Gs^Fds      , Gs^Fds      , Gs^Fds      , Rd          , Gg^Ve       , Gg^Fet      , Gs^Fds      , Gs^Fds      
Ss          , Ss          , Ww          , Gg          , Ss          , Gg          , Gg          , Re^Gvs      , Re^Gvs      , Re^Gvs      , Gg          , Ww          , Gg          , Gg          , Gg          , Gg          , Gg          , Gg          , Gg^Vh       , Gs^Fds      , Gs^Fds      , Gg          , Gg          , Gs^Fds      , Gs^Fds      , Gs^Fds      , Gs^Fds      , Gs^Fds      , Rd          , Gs^Fds      , Gs^Fds      , Gs^Fds      
Ss          , Gg          , Ss          , Ww          , Gg          , Gg          , Gg          , Re^Gvs      , Re^Gvs      , Re^Gvs      , Gg          , Ww          , Gg          , Gg          , Gg          , Gg          , Gg          , Gg          , Gg          , Gs^Fds      , Gg          , Gg          , Gg          , Gs^Fds      , Gs^Fds      , Gs^Fds      , Gs^Fds      , Gs^Fds      , Rd          , Gs^Fds      , Gs^Fds      , Gs^Fds      
Gg          , Ss          , Gg          , Ww          , Ww          , Gg          , Gg          , Re^Gvs      , Re^Gvs      , Re^Gvs      , Ww          , Ww          , Gg          , Gg          , Gg          , Gg          , Gg          , Gg          , Gg          , Gg          , Gg          , Gg          , Gg          , Gg          , Gg          , Gs^Fds      , Gs^Fds      , Gs^Fds      , Rd          , Gg^Fet      , Gg^Ve       , Gs^Fds      
Gg          , Gg          , Gg          , Ww          , Ww          , Gg          , Gg          , Gg^Vh       , Gg          , Gg          , Ww          , Gg          , Gg          , Gg          , Mm^Xm       , Gg          , Mm^Xm       , Gg          , Gg          , Gg          , Gg          , Gg          , Gg          , Gg          , Gg          , Gs^Fds      , Gs^Fds      , Gs^Fds      , Rd          , Rd          , Gs^Fds      , Gs^Fds      
Gg          , Gg          , Gg          , Ww          , Gg          , Gg          , Gg          , Gg          , Ww          , Ww^Bw\      , Gg          , Gg          , Mm^Xm       , Gg          , Ch          , Kh          , Ch          , Gg          , Mm^Xm       , Gg          , Gg          , Gg          , Gg          , Gg          , Gg          , Gg          , Rd          , Rd          , Gs^Fds      , Gs^Fds      , Gs^Fds      , Gs^Fds      
Gg          , Gg          , Gg          , Ww          , Ww          , Gg          , Gg          , Gg          , Ww          , Gg          , Gg          , Gg          , Kh          , Ch          , Co          , Co          , Co          , Ch          , Kh          , Gg          , Gg          , Gg          , Gg          , Gg          , Gg          , Gg          , Gs^Fds      , Gs^Fds      , Gs^Fds      , Gs^Fds      , Gs^Fds      , Gs^Fds      
Gg          , Gg          , Gg          , Ww          , Ww          , Gg          , Ww          , Ww          , Gg          , Gg          , Gg          , Mm^Xm       , Ch          , Co          , Ch          , Ch          , Ch          , Co          , Ch          , Mm^Xm       , Gg          , Gg          , Gg          , Gg          , Gg          , Gg          , Gs^Fds      , Gs^Fds      , Gg          , Gs^Fds      , Gs^Fds      , Gs^Fds      
Gg          , Gg          , Gg          , Ww          , Gg          , Ww          , Ww          , Gg          , Gg          , Gg          , Gg          , Gg          , Ch          , Co          , Ch          , 1 Kh        , Ch          , Co          , Ch          , Gg          , Gg          , Gg          , Gg          , Gg          , Gg          , Gg          , Gg          , Gg          , Gg          , Gs^Fds      , Gs^Fds      , Gs^Fds      
Gg          , Gg          , Ww          , Ww          , Gg          , Ww          , Ww          , Gg          , Gg          , Gg          , Gg          , Mm^Xm       , Kh          , Co          , Co          , Ch          , Co          , Co          , Kh          , Mm^Xm       , Gg          , Gg          , Gg          , Gg          , Gg          , Gg          , Gg          , Gg          , Gg          , Gg          , Gg          , Gs^Fds      
Gg          , Ww          , Ww          , Gg          , Gg          , Gg          , Gg          , Ww          , Ww          , Gg          , Gg          , Gg          , Mm^Xm       , Ch          , Ch          , Co          , Ch          , Ch          , Mm^Xm       , Gg          , Gg          , Gg          , Gg          , Gg          , Gg          , Gg          , Gs^Fds      , Gg          , Gg          , Gg          , Gg          , Gg          
Ww          , Ww          , Ww          , Gg          , Ww          , Ww          , Ww          , Ww          , Gg          , Gg          , Gg          , Gg          , Gg          , Rd          , Mm^Xm       , Kh          , Mm^Xm       , Gg          , Gg          , Gg          , Gg          , Gg          , Gg          , Gg          , Gg          , Gs^Fds      , Hh^Fms      , Gs^Fds      , Gs^Fds      , Gg          , Hh          , Hh          
Gg          , Gg          , Ww          , Ww          , Gg          , Ww          , Gg          , Gg          , Gg          , Gg          , Gg          , Gg          , Rd          , Rd          , Gg          , Gg          , Gg          , Gg          , Gg          , Gg          , Gg          , Gg          , Gg          , Gg          , Hh^Fms      , Gs^Fds      , Hh^Fms      , Hh^Fms      , Hh^Fms      , Hh^Fms      , Hh          , Hh          
Gg          , Gg          , Ww          , Gg          , Gg          , Gg          , Gg          , Gg          , Gg          , Gg          , Rd          , Rd          , Re^Gvs      , Gg          , Gg          , Gg          , Gg          , Gg          , Gg          , Gs^Fds      , Gs^Fds      , Gg          , Gg          , Gg          , Hh^Fms      , Hh^Fms      , Hh^Fms      , Hh^Fms      , Hh          , Hh          , Hh          , Mm          
Gg          , Gg          , Ww          , Ww          , Gg          , Gg          , Gg          , Gg          , Rd          , Rd          , Re^Gvs      , Re^Gvs      , Re^Gvs      , Gg          , Gg          , Gg          , Gg          , Gg          , Gg          , Gs^Fds      , Hh^Fms      , Gs^Fds      , Gs^Fds      , Gg          , Hh          , Hh^Fms      , Mm          , Mm          , Mm          , Hh          , Mm          , Mm          
Gg          , Gg          , Ww          , Ww          , Hh          , Gg          , Hh          , Gg          , Rd          , Re^Gvs      , Gg^Vh       , Re^Gvs      , Re^Gvs      , Gg          , Gg          , Gg          , Gg          , Gg          , Gg          , Hh^Fms      , Hh^Fms      , Gs^Fds      , Gg          , Gg          , Hh          , Mm          , Mm          , Mm          , Mm          , Mm          , Mm          , Mm          
Ww          , Ww          , Hh          , Gg          , Hh          , Hh          , Hh^Fms      , Hh^Fms      , Rd          , Re^Gvs      , Re^Gvs      , Re^Gvs      , Re^Gvs      , Gg          , Gg          , Gg          , Gs^Fds      , Gg          , Hh^Fms      , Hh^Fms      , Hh^Fms      , Gs^Fds      , Gg          , Gg          , Hh          , Mm          , Mm          , Mm          , Mm          , Mm          , Mm          , Mm          
Gg          , Hh          , Hh          , Hh          , Hh          , Hh^Fms      , Hh^Fms      , Hh          , Rd          , Re^Gvs      , Re^Gvs      , Re^Gvs      , Gg          , Gg          , Gg          , Gg          , Gs^Fds      , Gg          , Gg          , Hh^Fms      , Hh^Fms      , Hh^Fms      , Hh          , Hh          , Mm          , Mm          , Mm          , Mm          , Mm          , Mm          , Mm          , Mm          
Hh          , Hh          , Gg          , Gg          , Hh          , Hh^Fms      , Hh          , Gg          , Gg          , Rd          , Gg          , Gg          , Gg          , Gg          , Gs^Fds      , Gs^Fds      , Gs^Fds      , Gg          , Hh^Fms      , Gg          , Hh          , Mm          , Mm          , Mm          , Ce          , Ce          , Ce          , Mm^Vhh      , Mm          , Mm          , Mm^Xm       , Mm^Xm       
Hh          , Hh          , Gg          , Hh          , Hh          , Hh^Fms      , Hh          , Gg          , Rr          , Rd          , Gg          , Gg          , Gg          , Gs^Fds      , Hh^Fms      , Hh^Fms      , Hh^Fms      , Hh^Fms      , Hh          , Hh^Fms      , Hh          , Hh          , Mm          , Mm          , Ce          , 2 Ke        , Ce          , Mm          , Mm          , Mm          , Mm^Xm       , Mm^Xm       
Hh          , Hh          , Gg          , Hh          , Hh          , Hh          , Rp          , Rp^Vhc      , Rr          , Rr          , Rr          , Gg          , Gg          , Hh^Fms      , Hh^Fms      , Hh          , Hh          , Hh          , Hh          , Hh          , Mm          , Mm          , Mm          , Mm          , Mm^Vhh      , Ce          , Mm          , Mm          , Mm          , Mm          , Mm^Xm       , Mm^Xm       
Hh          , Hh^Fms      , Hh          , Gg          , Hh          , Rp^Vhc      , Rr          , Rr          , Rp          , Rp^Vhc      , Rr          , Rp^Vhc      , Gg          , Hh^Fms      , Hh^Fms      , Hh          , Mm          , Mm          , Mm          , Mm          , Mm          , Mm          , Mm          , Mm          , Mm          , Mm          , Mm          , Mm          , Mm          , Mm          , Mm^Xm       , Mm^Xm       
Hh          , Hh^Fms      , Hh^Fms      , Hh^Fms      , Hh          , Rr          , Rr          , Rp^Vhc      , Rr          , Rr          , Rp^Vhc      , Gg          , Hh          , Hh          , Mm          , Mm^Vhh      , Mm          , Mm          , Mm          , Mm          , Mm          , Mm          , Mm          , Mm          , Mm          , Mm          , Mm          , Mm          , Mm          , Mm^Vhh      , Mm^Xm       , Mm^Xm       
Hh          , Hh^Fms      , Hh^Fms      , Gg          , Hh^Fms      , Gg          , Gg          , Rr          , Rp^Vhc      , Gg          , Gg          , Gg          , Hh          , Hh          , Mm          , Mm          , Mm          , Mm          , Mm          , Mm          , Mm          , Mm          , Mm          , Mm          , Mm          , Mm          , Mm          , Mm          , Mm          , Mm          , Mm^Xm       , Mm^Xm       
Hh          , Hh          , Hh          , Hh^Fms      , Hh          , Hh^Fms      , Hh          , Rd          , Gg          , Gg          , Hh          , Hh          , Hh          , Hh          , Mm          , Mm          , Mm          , Mm          , Mm          , Mm          , Mm          , Mm          , Mm          , Mm          , Mm          , Mm          , Mm          , Mm          , Mm^Xm       , Mm^Xm       , Mm^Xm       , Mm^Xm       
