border_size=1
usage=map

Gg          , Gg          , Gg          , Gg          , Hh          , Hh          , Mm          , Mm          , Mm          , Mm          , Mm          , Mm          , Mm          , Mm          , Mm          , Ww          , Ww          , Ww          , Wo          , Wo          , Wo          , Mm          , Mm          , Mm          , Mm          , Mm          , Mm          , Mm          , Mm          , Mm          , Mm          , Mm          
Gg          , Gg          , Gg          , Gg          , Rd          , Hh          , Hh          , Mm          , Mm          , Mm          , Mm          , Mm          , Mm          , Mm          , Ww          , Ww          , Ww          , Ww          , Ww          , Wo          , Mm          , Mm          , Mm          , Mm          , Mm          , Mm          , Mm          , Mm          , Mm          , Mm          , Mm          , Hh          
Gg          , Gg          , Rd          , Rd          , Gg          , Rd          , Rd          , Rd          , Rd          , Rd          , Rd          , Hh          , Ww          , Ww          , Mm          , Ww          , Ww          , Ww          , Ww          , Wo          , Gs^Fds      , Mm          , Gs^Fds      , Mm          , Gs^Fds      , Hh^Fp       , Hh^Fp       , Mm          , Mm          , Mm          , Mm          , Hh          
Gg          , Gg          , Ww^Bw|      , Gg^Vo       , Ww          , Gg          , Ww          , Gg          , Gg          , Gg          , Ww^Bw|      , Gg          , Ww          , Mm          , Mm^Vhh      , Mm          , Ww          , Ww          , Ww          , Ww          , Gs^Fds      , Gs^Fds      , Gs^Fp       , Gs^Fds      , Gs^Fds      , Gs^Fds      , Hh^Fp       , Mm          , Mm          , Mm          , Hh          , Hh          
Ww          , Ww          , Co          , Ww          , Gg^Vo       , Ww          , Ww          , Gg          , Ww          , Ww          , Rd          , Ww          , Ww          , Hh          , Mm          , Mm          , Ww          , Ww          , Ww          , Ww          , Gs^Fp       , Gs^Fp       , Hh^Fp       , Hh^Fp       , Hh^Fp       , Hh^Fp       , Mm          , Mm          , Hh          , Hh          , Hh          , Mm          
Gg          , Co          , 3 Ko        , Co          , Ww          , Ww          , Gg          , Ww          , Gg          , Gg          , Rd          , Gs^Fms      , Gg          , Ww          , Ww          , Ww          , Mm          , Mm          , Mm          , Gs^Fp       , Gs^Fp       , Mm          , Mm          , Hh^Fp       , Mm          , Mm          , Mm          , Hh          , Hh          , Mm          , Mm          , Mm          
Gg          , Co          , Co          , Co          , Ww^Bw\      , Gg          , Gs^Fds      , Gs^Fds      , Gs^Fms      , Gs^Fms      , Rd          , Gs^Fms      , Ww          , Ww          , Gg          , Hh^Fds      , Hh^Fds      , Mm          , Mm          , Hh          , Mm          , Mm          , Mm          , Mm          , Mm          , Mm          , Mm^Vhh      , Hh          , Hh          , Mm          , Mm          , Mm          
Gg          , Gg          , Ww          , Ww          , Gg          , Rd          , Rd          , Gs^Fms      , Gg^Vo       , Gs^Fds      , Gs^Fms      , Rd          , Wwf         , Ww          , Gg          , Hh          , Hh          , Hh^Fds      , Hh          , Mm          , Mm          , Mm          , Hh          , Hh          , Hh          , Hh          , Hh          , Hh          , Hh          , Mm          , Mm          , Mm          
Gg          , Gg          , Ww^Bw\      , Gg^Vo       , Gs^Fms      , Gs^Fms      , Rd          , Gs^Fds      , Gs^Fms      , Gs^Fms      , Gs^Fms      , Gg          , Wwf         , Rd          , Rd          , Hh          , Hh^Fds      , Hh^Fds      , Hh^Fp       , Hh          , Mm          , Mm          , Hh          , Hh          , Mm          , Mm          , Mm          , Mm          , Mm          , Mm          , Mm          , Mm          
Ww          , Ww          , Gg          , Rd          , Rd          , Gs^Fds      , Rd          , Gs^Fms      , Gg          , Gg          , Gg          , Gg          , Ww          , Gg          , Rd          , Hh          , Hh^Fds      , Hh^Fds      , Hh^Fp       , Hh          , Mm          , Hh          , Hh          , Mm          , Mm          , Mm          , Mm          , Mm          , Mm          , Mm          , Mm          , Mm          
Gg          , Ww          , Gg          , Gs^Fms      , Gs^Fms      , Rd          , Rd          , Gg          , Wwf         , Ww          , Ww          , Ww          , Gg          , Gg          , Rd          , Hh^Fds      , Hh^Fds      , Hh^Fds      , Hh          , Hh          , Hh          , Hh          , Gs^Fms      , Gs^Fp       , Gs^Fp       , Mm          , Gs^Fp       , Mm          , Gs^Fp       , Mm          , Mm          , Mm          
Gg          , Gg          , Gg          , Gs^Fms      , Gg          , Gg          , Ww          , Wwf         , Rd          , Gg          , Ww          , Ww          , Gg          , Gs^Vht      , Hh          , Hh          , Hh^Fp       , Hh^Fp       , Gg^Fet      , Mm^Vhh      , Gs^Fms      , Gs^Fms      , Gs^Fms      , Gs^Fms      , Hh^Fds      , Hh^Fds      , Hh^Vc       , Gs^Fp       , Gs^Fp       , Gs^Fp       , Mm          , Mm          
Gg          , Gg          , Ww          , Gg          , Wwf         , Ww          , Ww          , Gg          , Gg          , Rd          , Gg          , Ww          , Ww          , Gg          , Rd          , Hh^Fp       , Gs^Fms      , Gs^Fms      , Gs^Fms      , Gs^Fms      , Ww          , Ww          , Ww          , Ww          , Ww          , Ww          , Ww          , Hh^Fds      , Gs^Fp       , Mm          , Mm          , Mm          
Ww          , Ww          , Gg^Efm         , Wwf         , Gg          , Ww          , Gg          , Gg          , Gg          , Rd          , Rd          , Gg          , Ww^Bw/      , Rd          , Ww          , Rd          , Gs^Vht      , Gs^Fms      , Ww          , Ww          , Gs^Fms      , Hh^Fds      , Ww          , Mm          , Mm          , Hh          , Hh          , Ww          , Ww          , Mm          , Mm          , Mm          
Gg^Efm         , Gg^Efm         , Gg^Efm         , Gg^Efm         , Gg^Efm         , Gg          , Gg          , Gg^Efm         , Rd          , Rd          , Gg          , Rd          , Hh^Fds      , Ww          , Gs^Fds      , Ww          , Ww          , Ww          , Gs^Fds      , Gs^Fms      , Gs^Fds      , Mm          , Ww          , Mm^Vhh      , Mm          , Mm          , Ww          , Ww          , Wo          , Ww          , Mm          , Mm          
Gg^Efm         , Gg^Efm         , Gg^Efm         , Gg^Efm         , Gg^Efm         , Gg^Efm         , Rd          , Rd          , Gg^Efm         , Gg          , Gg          , Gs^Vht      , Hh^Fds      , Hh^Fds      , Hh^Fds      , Gs^Fds      , Ww          , Hh^Fds      , Gs^Fms      , Hh^Fp       , Mm          , Mm          , Hh^Fds      , Ww          , Mm          , Mm          , Ww          , Wo          , Wo          , Ww          , Mm          , Mm          
Gg^Efm         , Gg^Efm         , Gg^Efm         , Gg^Efm         , Rd          , Rd          , Gg^Efm         , Gg          , Gg          , Gg          , Gs^Fds      , Gg          , Mm          , Gg          , Hh          , Gs^Fds      , Ww          , Hh^Fds      , Hh          , Mm          , Mm          , Mm          , Hh^Fds      , Ww          , Ww          , Ww          , Ww          , Wo          , Ww          , Ww          , Mm          , Mm          
Gg^Efm         , Re^Gvs      , Re^Gvs      , Re^Gvs      , Gg^Efm         , Gg^Efm         , Gg^Efm         , Gg          , Gg          , Gg          , Gs^Fds      , Gg          , Mm          , Gs^Fp       , Gs^Fp       , Gs^Fds      , Gs^Fds      , Ww          , Ww          , Hh^Fp       , Mm          , Mm          , Mm          , Hh^Fp       , Hh^Fp       , Mm          , Hh^Fp       , Ww          , Hh          , Mm          , Mm          , Mm          
Gg^Efm         , Re^Gvs      , Re^Gvs      , Re^Gvs      , Gg^Efm         , Gg^Efm         , Gg          , Gg          , Gs^Fds      , Gs^Fds      , Gs^Fds      , Hh          , Hh          , Gs^Fds      , Gs^Fds      , Gs^Fp       , Gs^Fp       , Ww          , Hh^Fp       , Hh^Fp       , Mm          , Mm          , Hh^Fp       , Hh^Fp       , Mm          , Hh^Fp       , Mm          , Mm          , Mm          , Mm          , Mm          , Mm          
Gg^Efm         , Gg^Vh       , Re^Gvs      , Re^Gvs      , Gg^Efm         , Gg^Efm         , Gg          , Gg          , Gg          , Gg          , Gs^Fds      , Hh          , Hh          , Mm          , Gs^Fp       , Gs^Fds      , Gs^Fds      , Wwf         , Hh^Fp       , Mm          , Mm          , Hh          , Mm          , Mm          , Mm          , Mm          , Mm          , Mm^Vhh      , Mm          , Mm          , Mm          , Mm          
Ww          , Ww          , Ww          , Re^Gvs      , Gg^Efm         , Gg^Efm         , Ww          , Gg^Efm         , Gg          , Gg          , Gs^Fds      , Mm          , Mm          , Hh          , Hh^Fp       , Hh^Fp       , Hh^Fp       , Wwf         , Hh          , Mm          , Mm          , Mm          , Mm          , Mm          , Mm          , Mm          , Mm          , Mm          , Mm          , Mm          , Mm          , Mm          
Gg^Efm         , Gg^Efm         , Gg^Efm         , Ww          , Ww          , Wwf         , Gg^Efm         , Ww          , Ww          , Gg          , Re          , Mm          , Mm          , Mm          , Mm^Vhh      , Hh          , Ww          , Ww          , Hh          , Mm          , Mm          , Mm          , Mm          , Mm          , Mm          , Mm          , Mm          , Mm          , Mm          , Mm          , Mm          , Mm          
Gg^Efm         , Gg^Efm         , Gg^Efm         , Gg^Efm         , Ww          , Gg^Efm         , Gg^Efm         , Gg^Efm         , Gg^Efm         , Ww          , Wwf         , Mm          , Wwf         , Mm          , Wwf         , Wwf         , Ww          , Ww          , Hh^Fp       , Mm          , Mm          , Mm          , Mm          , Mm          , Mm          , Mm          , Mm          , Mm          , Mm          , Mm          , Mm          , Mm          
Gg          , Gg^Efm         , Ww          , Wwf         , Gg^Efm         , Gg^Efm         , Gg^Efm         , Gg^Efm         , Gg^Efm         , Gg^Efm         , Gg^Vh       , Wwf         , Re          , Wwf         , Mm          , Mm          , Mm^Vhh      , Ww          , Hh^Fp       , Hh^Fp       , Mm          , Mm          , Mm          , Mm          , Mm          , Mm          , Mm          , Mm          , Mm          , Mm          , Mm          , Mm          
Ww          , Ww          , Gg          , Ww          , Gg^Efm         , Gg^Efm         , Gg^Efm         , Gg^Efm         , Gg^Efm         , Gg^Efm         , Re          , Re          , Re          , Re          , Mm          , Mm          , Mm          , Wwf         , Ww          , Mm          , Mm^Vhh      , Mm          , Mm          , Mm          , Ch          , Mm          , Mm          , Mm          , Mm          , Mm          , Mm          , Mm          
Ww          , Hh^Fms      , Gg^Efm         , Gg^Efm         , Gg          , Gg^Efm         , Gg^Efm         , Gg^Efm         , Gg^Efm         , Re          , Re          , Re          , Mm^Vhh      , Mm          , Mm          , Mm          , Ww          , Wwf         , Wwf         , Mm          , Mm          , Mm          , Mm          , Ch          , Mm          , Mm          , Mm          , Mm          , Mm          , Mm          , Mm          , Mm          
Hh^Fms      , Hh^Fms      , Hh^Fms      , Gg^Efm         , Gg          , Gg^Efm         , Gg^Efm         , Gg          , Re          , Re          , Re          , Re          , Re          , Mm          , Mm          , Ww          , Ww          , Ww          , Wwf         , Hh^Vhh      , Mm^Xm       , Mm^Xm       , Mm^Xm       , Ch          , 2 Kh        , Mm          , Mm          , Mm^Xm       , Mm^Xm       , Mm^Xm       , Mm^Xm       , Mm^Xm       
Hh^Fms      , Hh^Fms      , Hh^Fms      , Gg^Vc       , Hh^Fms      , Hh^Fms      , Hh^Fms      , Gg          , Hh          , Re          , Re          , Re          , Ww          , Mm          , Wwf         , Ww          , Ww          , Ww          , Wo          , Hh          , Ww          , Mm^Xm       , Mm^Xm       , Ch          , Ch          , Mm          , Hh          , Mm^Xm       , Mm^Xm       , Mm^Xm       , Mm^Xm       , Mm^Xm       
Hh^Fms      , Hh          , Hh          , Hh^Fms      , Ce          , Ce          , Ce          , Hh^Fms      , Hh          , Hh^Fds      , Hh          , Ww          , Hh^Vhh      , Ww          , Mm          , Ww          , Ww          , Wo          , Wo          , Wo          , Ww          , Mm^Xm       , Mm^Xm       , Ch          , Ch          , Mm          , Mm^Xm       , Hh          , Mm^Xm       , Mm^Xm       , Mm^Xm       , Mm^Xm       
Hh^Fms      , Hh^Fms      , Hh          , Hh^Fms      , Ce          , 1 Ke        , Ce          , Hh^Fms      , Hh^Fds      , Hh          , Ww          , Ww          , Mm          , Mm          , Mm          , Mm^Xm       , Ww          , Wo          , Wo          , Wo          , Ww          , Mm^Xm       , Mm^Xm       , Mm^Xm       , Mm^Xm       , Mm^Xm       , Mm^Xm       , Hh          , Mm^Xm       , Mm^Xm       , Mm^Xm       , Mm^Xm       
Hh^Fms      , Gg^Vc       , Hh^Fms      , Hh^Fms      , Ce          , Ce          , Ce          , Hh^Fms      , Ww          , Wwf         , Hh          , Mm          , Mm          , Mm          , Mm^Xm       , Ww          , Ww          , Wo          , Ww          , Ww          , Ww          , Mm^Xm       , Mm^Xm       , Mm^Xm       , Mm^Xm       , Mm^Xm       , Mm^Xm       , Hh          , Mm^Xm       , Mm^Xm       , Mm^Xm       , Mm^Xm       
Hh^Fms      , Hh^Fms      , Hh^Fms      , Hh^Fms      , Ce          , Ce          , Ce          , Hh^Fms      , Ww          , Hh          , Mm          , Mm          , Mm^Xm       , Mm^Xm       , Mm^Xm       , Mm^Xm       , Mm^Xm       , Ww          , Mm^Xm       , Ww          , Mm^Xm       , Mm^Xm       , Mm^Xm       , Mm^Xm       , Mm^Xm       , Mm^Xm       , Mm^Xm       , Mm^Xm       , Mm^Xm       , Mm^Xm       , Mm^Xm       , Mm^Xm       
