border_size=1
usage=map

Mm^Xm       , Mm^Xm       , Mm^Xm       , Mm^Xm       , Mm^Xm       , Mm^Xm       , Mm^Xm       , Mm          , Mm          , Mm          , Mm          , Mm          , Mm          , Mm          , Hh^Fmf      , Hh          , Hh          , Gs^Fp       , Gs^Fp       , Gs^Fp       , Gs^Fp       , Gs^Fp       , Gs^Fp       , Gs^Fp       , Gs^Fp       , Gs^Fp       , Gs^Fp       
Mm^Xm       , Mm^Xm       , Mm^Xm       , Mm^Xm       , Mm^Xm       , Mm^Xm       , Mm          , Mm          , Mm          , Mm          , Mm          , Mm          , Hh          , Hh^Fmf      , Hh^Fmf      , Hh^Fmf      , Gs^Fmf      , Gs^Fp       , Gs^Fp       , Gs^Fp       , Gs^Fmf      , Gs^Fmf      , Gs^Fp       , Gs^Fmf      , Gs^Fp       , Gs^Fp       , Gs^Fp       
Mm^Xm       , Mm^Xm       , Mm^Xm       , Mm^Xm       , Mm          , Mm          , Mm          , Mm          , Mm          , Mm          , Hh          , Hh          , Hh^Fmf      , Hh^Fmf      , Hh^Fp       , Hh^Fp       , Hh^Fp       , Gs^Fp       , Gs^Fp       , Gs^Fmf      , Gg^Vc       , Gs^Fp       , Ce          , Gs^Fmf      , Gs^Fmf      , Gs^Fmf      , Gs^Fp       
Mm^Xm       , Mm^Xm       , Mm          , Mm          , Mm          , Mm          , Hh^Fmf      , Mm          , Hh^Fmf      , Hh          , Hh^Fmf      , Hh^Fmf      , Hh^Fdf      , Hh^Fp       , Hh^Fp       , Gs^Fmf      , Gs^Fp       , Gs^Fp       , Gs^Fmf      , Gs^Fp       , Gg          , Gg          , 2 Ke        , Gg          , Gs^Fmf      , Gs^Fmf      , Gs^Fp       
Mm^Xm       , Mm^Xm       , Mm          , Mm          , Hh          , Hh          , Hh^Fmf      , Hh^Fmf      , Hh^Fmf      , Hh^Fmf      , Hh^Fmf      , Hh^Fdf      , Gs^Fmf      , Hh^Fp       , Gs^Fmf      , Gs^Fmf      , Gs^Fmf      , Gs^Fmf      , Gs^Fp       , Gg          , Rd          , Ce          , Gg          , Ce          , Gg^Vc       , Gs^Fmf      , Gs^Fp       
Mm          , Mm          , Mm          , Mm          , Hh          , Hh^Fmf      , Hh^Fmf      , Hh^Fmf      , Hh^Fdf      , Hh^Fp       , Hh^Fp       , Hh^Fp       , Gs^Fp       , Gs^Fmf      , Gs^Fp       , Gs^Fmf      , Gs^Fmf      , Gs^Fp       , Gg          , Gg          , Gs^Fp       , Gs^Fp       , Gs^Fmf      , Gs^Fmf      , Gs^Fp       , Gs^Fmf      , Gs^Fp       
Mm          , Mm          , Mm          , Mm          , Hh          , Hh^Fmf      , Hh^Fmf      , Hh^Fdf      , Hh^Fdf      , Hh^Fp       , Gs^Fmf      , Gs^Fp       , Gs^Fp       , Gs^Fp       , Gs^Fmf      , Gs^Fmf      , Gs^Fmf      , Gs^Fmf      , Rd          , Rd          , Gs^Fp       , Gs^Fmf      , Gs^Fmf      , Gs^Fmf      , Gs^Fmf      , Gs^Fmf      , Gs^Fp       
Mm          , Mm          , Mm          , Mm          , Hh          , Hh^Fmf      , Hh          , Gs^Fmf      , Hh^Fdf      , Hh^Fdf      , Gs^Fmf      , Gs^Fp       , Gs^Fmf      , Gs^Fmf      , Gs^Fp       , Gs^Fmf      , Gs^Fp       , Gs^Fp       , Rd          , Gg          , Gg          , Gs^Fp       , Gg^Vc       , Gs^Fp       , Gs^Fp       , Gs^Fp       , Gs^Fp       
Mm          , Mm          , Mm          , Mm          , Hh          , Hh^Fmf      , Hh^Fdf      , Hh^Fdf      , Gs^Fmf      , Gs^Fmf      , Gs^Fp       , Gs^Fp       , Gs^Fp       , Gs^Fp       , Gs^Fmf      , Gs^Fp       , Gs^Fmf      , Gs^Fmf      , Gg          , Gg          , Gg          , Gg          , Gg          , Gs^Fp       , Gs^Fp       , Gs^Fp       , Gg          
Ww          , Ww          , Ww          , Mm          , Hh^Vhh      , Hh^Fmf      , Hh^Fdf      , Hh^Fp       , Gs^Fmf      , Gs^Fp       , Gs^Fmf      , Gs^Fmf      , Gs^Fmf      , Gs^Fmf      , Gs^Fmf      , Gs^Fmf      , Gs^Fms      , Gs^Fmf      , Gg          , Gg          , Gs^Fms      , Gs^Fmf      , Gs^Fmf      , Gg          , Gg          , Gs^Fp       , Gg          
Mm          , Mm          , Mm          , Ww          , Hh^Fmf      , Hh^Fmf      , Gs^Fmf      , Hh^Fp       , Gs^Fmf      , Gs^Fmf      , Gs^Fmf      , Gs^Fmf      , Gs^Fmf      , Gs^Fmf      , Gs^Fms      , Gs^Fms      , Gs^Fmf      , Gs^Fmf      , Gg          , Gg          , Gs^Fms      , Gs^Fmf      , Gs^Fmf      , Gs^Fmf      , Gg          , Gg          , Gg          
Mm          , Mm          , Mm          , Ww          , Ww          , Hh^Fmf      , Gs^Fmf      , Gs^Fmf      , Gs^Fp       , Gs^Fp       , Gs^Fms      , Gs^Fmf      , Gs^Fmf      , Gs^Fmf      , Gg          , Gs^Fmf      , Gs^Fms      , Gs^Fms      , Gg          , Gg          , Gs^Fms      , Gs^Fmf      , Gs^Fmf      , Gs^Fmf      , Gs^Fmf      , Gs^Fmf      , Gs^Fmf      
Mm          , Mm          , Hh          , Hh          , Gs^Fmf      , Ww          , Ww          , Gs^Fmf      , Gs^Fp       , Gs^Fp       , Gs^Fms      , Gs^Fms      , Gg          , Gg          , Gg          , Gg          , Gg          , Gg          , Gg          , Gg          , Gs^Fms      , Gs^Fmf      , Gs^Fmf      , Gs^Fms      , Gs^Fmf      , Gs^Fmf      , Gs^Fmf      
Hh          , Hh          , Gs^Fmf      , Gs^Fmf      , Gs^Fmf      , Ww          , Ww^Bw/      , Ww^Bw/      , Gg          , Gg          , Gg          , Gs^Fms      , Gg          , Gg^Vc       , Gg          , Gg          , Gg          , Gg          , Gg          , Gg          , Gs^Fms      , Gs^Fms      , Gs^Fmf      , Gs^Fms      , Gs^Fmf      , Gs^Fms      , Gs^Fmf      
Gs^Fmf      , Gs^Fmf      , Gs^Fmf      , Gs^Fmf      , Gs^Fmf      , Ww^Bw/      , Ww          , Ww          , Gg          , Gg          , Gg          , Gs^Fms      , Ce          , Ce          , Ce          , Ce          , Ce          , Ce          , Ce          , Gg          , Gg          , Gs^Fms      , Gs^Fms      , Gs^Fms      , Gs^Fms      , Gs^Fmf      , Gs^Fmf      
Gs^Fmf      , Gs^Fmf      , Gs^Fmf      , Gs^Fmf      , Gg          , Ww          , Ww          , Ww          , Gg          , Gg          , Gg          , Gg          , Ce          , Gg          , Re          , Gg          , Gg          , Gg          , Ce          , Gg          , Gg          , Gs^Fms      , Gs^Fms      , Gs^Fms      , Gs^Fms      , Gs^Fms      , Gs^Fmf      
Gs^Fmf      , Gs^Fmf      , Gs^Fmf      , Gg          , Ww          , Ww          , Ww          , Ww          , Gg          , Gg          , Gg          , Gg          , Ce          , Gg          , Gg          , Re          , Re          , Re          , Ce          , Gg          , Gg          , Gg          , Gs^Fms      , Gs^Fms      , Gs^Fms      , Gs^Fms      , Gs^Fms      
Gg          , Gg          , Gs^Fmf      , Gg          , Ww          , Ww          , Ww          , Ww          , Gg          , Gg          , Gg          , Gg          , Ce          , Gg          , Gg          , Gg          , Gg          , Re          , Ce          , Gg          , Gg          , Gg          , Gg          , Gs^Fms      , Gg          , Gs^Fms      , Gs^Fms      
Gg          , Gg          , Gs^Fmf      , Gg          , Ww          , Ww          , Ww          , Gg          , Gg          , Gg          , Gg          , Gg          , Ce          , Re          , Re          , Gg          , Re          , Re          , Ce          , Gg          , Gg          , Gg          , Gg          , Gg          , Gg          , Gg          , Gg          
Gg          , Gg          , Gs^Fmf      , Gg          , Ww          , Ww          , Ww          , Ww          , Gg^Vc       , Gg          , Gg          , Gg          , Ce          , Gg          , Gg          , Re          , Ce          , Re          , Ce          , Gg          , Gg          , Gg          , Gg          , Gg          , Gg          , Gs^Fp       , Gs^Fmf      
Gg          , Gg          , Gg          , Gg          , Ww          , Ww          , Gg          , Ww          , Gg          , Gg          , Rd          , Rd          , Rd          , Ce          , Re          , Ce          , Gg^Fet      , Ce          , Gg          , Gg          , Gg          , Gg          , Gg          , Gg          , Gg          , Gs^Fp       , Gs^Fp       
Gg          , Gg^Wm       , Gg          , Gg          , Ww^Bw\      , Ww          , Gs^Fmf      , Ww          , Ww^Bw/      , Rd          , Gg          , Gg          , Gg          , Gg          , Re          , Gg^Ve       , Gg^Fet      , Gg          , Gg          , Gg          , Gg          , Gg          , Gg          , Gg          , Gg          , Gs^Fmf      , Gs^Fp       
Gg          , Gg          , Gg          , Ww          , Ww          , Gg          , Rd          , Rd          , Ww          , Gg          , Gg          , Gg^Wm       , Gg          , Re^Gvs      , Re^Gvs      , Gg^Fet      , Gg          , Gg          , Gg          , Gg          , Gg          , Gg          , Gg          , Gg          , Gs^Fp       , Gs^Fmf      , Gs^Fp       
Gg          , Gg          , Ww          , Ww          , Gg          , Gg          , Rd          , Gs^Fmf      , Ww          , Ww          , Gg          , Gg          , Gg          , Gg^Vc       , Re^Gvs      , Gg          , Gg          , Gg          , Gg          , Gg          , Gg          , Gg          , Gs^Fp       , Gs^Fmf      , Gs^Fmf      , Gs^Fmf      , Gs^Fp       
Gg          , Ww          , Gg^Vc       , Gg          , Ce          , Ce          , Ce          , Gg          , Gg^Vc       , Ww          , Ww          , Gg          , Gg          , Gg          , Gg          , Re^Gvs      , Gg          , Gg          , Gs^Fp       , Gg          , Gs^Fmf      , Gs^Fmf      , Gs^Fmf      , Gs^Fmf      , Gs^Fmf      , Gs^Fmf      , Gs^Fmf      
Ww          , Ww          , Gg          , Gg          , Ce          , 1 Ke        , Ce          , Gg          , Gg          , Ww          , Ww          , Gg          , Gg          , Gg          , Gg          , Gg          , Gs^Fp       , Gs^Fp       , Gs^Fmf      , Gs^Fmf      , Gs^Fmf      , Gs^Fmf      , Gs^Fp       , Gs^Fmf      , Gs^Fp       , Gs^Fp       , Gs^Fp       
Ww          , Ww          , Gg          , Gg          , Ce          , Ce          , Ce          , Gg          , Gg          , Ww          , Ww          , Ww          , Gg          , Gg          , Gg          , Gs^Fp       , Gs^Fp       , Gs^Fmf      , Gs^Fp       , Gs^Fmf      , Gs^Fp       , Gs^Fp       , Gs^Fp       , Gs^Fp       , Gg          , Gs^Fmf      , Gg          
