border_size=1
usage=map

Ss          , Ss          , Ss          , Ss          , Ss          , Ss          , Ss          , Ss          , Ww          , Ww          , Ww          , Ss          , Hh          , Hh          , Ss          , Ss          , Hh          , Hh          , Hh          , Ss          , Ss          , Ss          , Gg          , Ss          , Hh          , Ss          , Ss          , Gg          , Gg          , Gg          , Gs^Fp       , Gs^Fp       , Gs^Fp       , Gs^Fp       , Gs^Fp       , Gs^Fp       , Gs^Fp       , Gs^Fp       , Gs^Fp       , Gs^Fp       , Gg          , Gg          
Gs^Fp       , Ss          , Ss          , Ss          , Gs^Fp       , Gs^Fp       , Gs^Fp       , Gs^Fp       , Ss          , Ww          , Ss^Vhs      , Ww          , Ww          , Hh          , Hh          , Hh          , Hh          , Hh          , Ss          , Gg          , Gg          , Gg          , Gg          , Gg          , Ss          , Gg          , Re          , Ss          , Ss          , Ss          , Gs^Fp       , Gs^Fp       , Gs^Fp       , Gs^Fp       , Gs^Fp       , Gs^Fp       , Gg          , Gg          , Gg          , Gs^Fp       , Gg          , Gg          
Ss          , Ss          , Ss          , Ss          , Gs^Fp       , Gs^Fp       , Gs^Fp       , Gs^Fp       , Gs^Fp       , Ww          , Ss          , Ss          , Ww          , Ww          , Hh          , Hh          , Ww          , Ww          , Ww          , Gg          , Ww          , Gg^Ve       , Gg          , Gg          , Ww          , Gg          , Re          , Ss          , Ss          , Ss          , Gg          , Gs^Fp       , Gs^Fp       , Gs^Fp       , Ss          , Ss          , Ss          , Gg          , Gg          , Gg          , Gg          , Gg          
Gg          , Gg          , Ss          , Ch          , Ch          , Ch          , Gs^Fp       , Gs^Fp       , Ww          , Gs^Fp       , Gs^Fp       , Ss          , Ss          , Ww          , Hh          , Ss          , Ww          , Ww          , Gg          , Ww          , Ww          , Ww          , Ww          , Gg          , Ww          , Ww          , Gg          , Re          , Ss          , Ss          , Gs^Fp       , Gs^Fp       , Gs^Fp       , Ss          , Ss          , Ss          , Gg          , Ss          , Gg          , Gg          , Gg          , Gg          
Gg          , Gg          , Ss          , Ch          , 3 Kh        , Ch          , Ww          , Gs^Fp       , Ww          , Ww          , Gs^Fp       , Ss          , Ss          , Ww          , Ww          , Ww          , Ww          , Ss          , Ss          , Gg          , Gs^Fp       , Gg          , Ww          , Ww          , Ss          , Ss          , Ww          , Re          , Gg          , Gg          , Gs^Fp       , Gs^Fp       , Gs^Fp       , Ss          , Gs^Fp       , Ss          , Ss          , Gg          , Gg          , Gg^Ve       , Re          , Re          
Ss          , Ss          , Ch          , Ch          , Ch          , Re          , Ww^Bw\      , Ww          , Ww          , Ww          , Gs^Fp       , Ss          , Ss          , Hh          , Hh          , Hh          , Hh          , Hh          , Ss          , Gs^Fp       , Gs^Fp       , Gg          , Ww          , Ww          , Gg          , Ss          , Ss          , Ss^Bw|      , Ww          , Gg          , Gg          , Gs^Fp       , Gs^Fp       , Gs^Fp       , Gg^Ve       , Gg          , Gs^Fp       , Gg          , Re          , Re          , Gg          , Re          
Ss          , Ch          , Ss          , Ss          , Ss          , Ss^Vhs      , Ww          , Re          , Ww^Bw\      , Ww          , Gs^Fp       , Ss          , Ss          , Hh          , Hh          , Hh          , Ww          , Ss          , Ww          , Ss          , Hh          , Gs^Fp       , Gs^Fp       , Gg          , Ss          , Gg          , Ss          , Re          , Re          , Ww          , Re          , Gg          , Gs^Fp       , Gs^Fp       , Re          , Gs^Fp       , Re          , Re          , Gg          , Gg          , Gg          , Gg          
Ss          , Ss          , Ss          , Ss          , Ss          , Gg          , Ww          , Ss          , Ww          , Ww^Bw\      , Re          , Gs^Fp       , Ss          , Ww          , Ss^Vhs      , Ss          , Hh          , Ww          , Hh          , Mm          , Ss          , Hh          , Gs^Fp       , Ww          , Ss          , Gg          , Gg          , Ss^Bw|      , Re          , Re          , Gg          , Re          , Re          , Re          , Gs^Fp       , Re          , Gs^Fp       , Gg          , Gg          , Gg          , Gg          , Gg          
Ss          , Ss          , Gg          , Gg          , Ww          , Ww          , Gg^Ve       , Ss          , Ww          , Ww          , Re          , Gs^Fp       , Ss          , Ww          , Ss          , Ss          , Ww          , Ss^Vhs      , Gs^Fp       , Ss          , Ss          , Ss          , Gs^Fp       , Hh          , Gg          , Gg          , Gg          , Re          , Gg          , Ss          , Ss          , Ss          , Gs^Fp       , Gs^Fp       , Gg          , Gs^Fp       , Gs^Fp       , Gg          , Gs^Fp       , Gg          , Gg          , Ss          
Ss          , Gg          , Ww          , Ww          , Gg          , Gg          , Ss          , Ss          , Ww          , Gs^Fp       , Re          , Gs^Fp       , Ss          , Ww          , Ww          , Ww          , Ss          , Ww          , Ss          , Ss          , Ss          , Ss          , Gs^Fp       , Gg          , Gg          , Gg          , Ce          , Re          , Gg          , Ss          , Gg          , Ss^Vhs      , Gg          , Gs^Fp       , Re          , Gg          , Gs^Fp       , Gs^Fp       , Gs^Fp       , Gs^Fp       , Gs^Fp       , Gg          
Gg          , Gg          , Ww          , Gg^Ve       , Ss          , Ss          , Ss          , Ss          , Ww          , Gs^Fp       , Ss          , Ch          , Ww          , Ww          , Ww          , Ss          , Ww          , Ww          , Ww          , Ss          , Ss          , Ss          , Gg          , Gg          , Gg          , Ce          , 2 Ke        , Ce          , Gg          , Gg          , Gg          , Ss          , Gg          , Gg^Ve       , Ss          , Ww          , Ww          , Gs^Fp       , Ss          , Gg          , Gg          , Gg          
Gg          , Ww          , Gg          , Gg          , Ss          , Ss          , Ss          , Ww          , Ww          , Ss          , Ss          , Ww^Bw|      , Ss          , Ss^Vhs      , Ss          , Ww          , Ww          , Ww          , Ss          , Ww          , Ww          , Gg          , Gg          , Gg          , Ce          , Ce          , Ce          , Ce          , Gg          , Gs^Fp       , Gs^Fp       , Gs^Fp       , Gs^Fp       , Gg          , Gg          , Ww          , Gg          , Ww          , Gs^Fp       , Ww          , Gs^Fp       , Gg          
Ww          , Ww          , Ss          , Ss          , Ss          , Ss          , Ww          , Ww          , Ww          , Ss          , Ss          , Ch          , Ww^Bw\      , Ss          , Gg          , Ss          , Ss          , Ss          , Ss          , Ss          , Ww          , Ww          , Ss          , Gg          , Ww^Bw/      , Ce          , Gg          , Re          , Gg          , Gg          , Ss^Vhs      , Ss          , Ss          , Gg          , Gg          , Gg          , Gg          , Gg          , Gs^Fp       , Gs^Fp       , Gs^Fp       , Gs^Fp       
Ww          , Ss          , Ss          , Ss          , Ss          , Ww          , Ww          , Ww          , Ww          , Ss          , Ss          , Ss          , Ss          , Re          , Gg          , Ss          , Ss          , Ss          , Ss          , Ss          , Ww          , Ww          , Ww^Bw/      , Re          , Gg          , Ww          , Ww          , Re          , Re          , Ww          , Ww          , Ss          , Ss          , Ww          , Ss          , Gg          , Gg          , Ss          , Ss          , Gs^Fp       , Gs^Fp       , Gs^Fp       
Ww          , Ss          , Ss          , Ss          , Ss          , Ww          , Ww          , Ww          , Ww          , Ss          , Gg          , Gg          , Gg          , Re          , Gg          , Ss          , Gs^Fp       , Gs^Fp       , Ss          , Ss          , Re          , Re          , Hh          , Ww          , Ww          , Ss          , Ww          , Re          , Ss          , Ww^Bw\      , Ww^Bw\      , Ss          , Gs^Fp       , Gs^Fp       , Gg          , Ss          , Gg          , Gg          , Ss^Vhs      , Ss          , Ss          , Ss          
Ww          , Hh          , Ss          , Gg          , Gg          , Ss          , Ww          , Ww          , Ss^Vhs      , Gg          , Gg          , Gg          , Gg          , Re          , Ww^Bw\      , Ss          , Gs^Fp       , Gs^Fp       , Re          , Ww^Bw/      , Gg          , Gg^Ve       , Hh          , Mm          , Mm          , Gg^Ve       , Ww^Bw/      , Ch          , Ww          , Ww          , Ww          , Ch          , Ss          , Gs^Fp       , Gg          , Gg          , Gg          , Gg          , Ss          , Ss          , Ss          , Ss          
Mm          , Mm          , Ss          , Gg          , Gg          , Gg          , Ww          , Ww          , Ss          , Gg          , Gg          , Gg          , Ss          , Ss          , Ss          , Re          , Re          , Re          , Ss          , Ss          , Gg          , Gg          , Hh          , Mm          , Mm          , Mm          , Hh          , Ww          , Ww          , Ss          , Ww          , Ww^Bw|      , Ss          , Gg          , Gg          , Ss          , Gg          , Gg          , Gg^Ve       , Gg          , Gg          , Ss          
Mm          , Mm          , Hh          , Gg          , Gg          , Gg          , Ss          , Ww          , Ss          , Ss          , Ss          , Ss          , Ss          , Ss          , Gs^Fp       , Re          , Re          , Ss          , Ss          , Ss          , Ss          , Ss          , Hh          , Mm          , Mm          , Mm          , Hh          , Hh          , Ss          , Ss          , Ss          , Ch          , Ww          , Gg          , Gg          , Gg          , Gs^Fp       , Gg          , Gs^Fp       , Gg          , Gs^Fp       , Ss          
Mm          , Hh          , Ss^Vhs      , Gg          , Gg          , Gg          , Ss          , Ww          , Ww          , Ww          , Ww          , Ss          , Ww          , Ss          , Ss          , Ss          , Ch          , Ss          , Ss          , Ss          , Ss          , Hh          , Mm          , Mm          , Mm          , Mm          , Mm          , Hh          , Ss          , Gs^Fp       , Ss          , Re          , Re          , Ss          , Ss          , Gg          , Ss          , Gs^Fp       , Gs^Fp       , Gs^Fp       , Gs^Fp       , Ss          
Mm          , Hh          , Gg          , Ss          , Gg          , Gg          , Gg          , Gg          , Ss          , Ww          , Ss          , Ww          , Ww          , Ss          , Ss          , Ss          , Ss          , Ch          , Ss          , Ss          , Ss          , Hh          , Mm          , Mm          , Mm          , Mm          , Mm          , Hh          , Gs^Fp       , Gs^Fp       , Gs^Fp       , Gs^Fp       , Gs^Fp       , Re          , Re          , Ss          , Re          , Ss          , Gs^Fp       , Gs^Fp       , Gg          , Gg          
Hh          , Hh          , Ss          , Ss          , Gg          , Gg          , Gg          , Gg          , Ss          , Ss          , Gs^Fp       , Ww          , Ww          , Hh          , Ss          , Ss          , Ss^Vhs      , Re          , Gs^Fp       , Ss          , Ss          , Ss          , Hh          , Hh          , Hh          , Hh          , Hh          , Hh          , Ss          , Gs^Fp       , Gs^Fp       , Gs^Fp       , Gs^Fp       , Ss          , Ss          , Re          , Gs^Fp       , Re          , Re          , Re          , Re          , Re          
Hh          , Hh          , Ss          , Gg          , Gg          , Gg          , Ss          , Gg          , Ss          , Ss          , Ss          , Ss          , Ww          , Ss          , Ss          , Ss          , Ss          , Re          , Gs^Fp       , Ss          , Ss^Vhs      , Ss          , Ss          , Ss          , Hh          , Hh          , Hh          , Hh          , Ss          , Ss          , Ss          , Gs^Fp       , Ss          , Ss          , Ss          , Gs^Fp       , Gs^Fp       , Ss          , Ss          , Ss          , Ss          , Ss          
Hh          , Ss          , Gg          , Gg          , Gg          , Ss          , Ss          , Ww          , Ss          , Ss          , Ss          , Ss          , Ss          , Gg          , Gg          , Ss          , Ss          , Ch          , Ch          , Ss          , Ss          , Ss          , Ss          , Ss          , Ss          , Ss          , Hh          , Hh          , Ss          , Ss          , Ss          , Ss          , Ss          , Ss          , Ss          , Ss          , Ss          , Ss          , Ss          , Ss          , Ss          , Ss          
Hh          , Hh          , Ss          , Ss          , Ss          , Gg          , Ss          , Ww          , Gg^Ve       , Gg          , Ss          , Ss          , Ss          , Ss          , Ss          , Ss          , Ss          , Ss          , Ww^Bw|      , Ss          , Ss          , Ss          , Ww          , Ww          , Ww          , Ss          , Ss          , Hh          , Ss^Vhs      , Ss          , Ss          , Ss          , Ss          , Ss          , Ss^Vhs      , Ss          , Ss          , Gs^Fp       , Gs^Fp       , Ss          , Gs^Fp       , Ss          
Mm          , Mm          , Hh          , Hh          , Ss          , Ss          , Ss          , Ww          , Ww          , Ww          , Ww          , Ss          , Gs^Fp       , Gs^Fp       , Ss          , Ss          , Ss          , Ss^Vhs      , Re          , Ss          , Ss          , Ss          , Ss          , Ww          , Ss          , Ww          , Ww          , Ss          , Ss          , Ww          , Ww          , Gg          , Ss          , Ww          , Ww          , Ww          , Ww          , Ww          , Ss          , Gs^Fp       , Gg^Ve       , Gs^Fp       
Mm          , Mm          , Mm          , Hh          , Ss          , Ss^Vhs      , Ww          , Ww          , Ww          , Ww          , Ww          , Gs^Fp       , Gs^Fp       , Gs^Fp       , Gs^Fp       , Ss          , Ss          , Gg          , Hh          , Re          , Re          , Ss          , Ss          , Ss          , Gs^Fp       , Gs^Fp       , Ss          , Ss          , Ww          , Ww          , Ww          , Ww          , Ww          , Ww          , Ss          , Ss          , Ww          , Ww          , Gs^Fp       , Gs^Fp       , Gs^Fp       , Gs^Fp       
Hh          , Mm          , Hh          , Hh          , Ss          , Ss          , Ss          , Ss          , Ww          , Ww          , Ww          , Gs^Fp       , Gs^Fp       , Gs^Fp       , Gs^Fp       , Ss          , Ss          , Hh          , Mm          , Mm          , Hh          , Ww^Bw\      , Re          , Gs^Fp       , Gs^Fp       , Gs^Fp       , Ss          , Ss          , Ww          , Ss          , Ss          , Ww          , Ss^Vhs      , Ss          , Ss          , Ss          , Ww          , Ss          , Ss          , Gs^Fp       , Gs^Fp       , Gs^Fp       
Mm          , Hh          , Hh          , Hh          , Ss          , Ss          , Ss          , Ss          , Ww          , Gs^Fp       , Gs^Fp       , Gs^Fp       , Gs^Fp       , Gs^Fp       , Ss          , Ss          , Hh          , Hh          , Mm          , Mm          , Mm          , Ss          , Ss          , Re          , Gs^Fp       , Gs^Fp       , Gs^Fp       , Ww          , Ww          , Gs^Fp       , Gs^Fp       , Gs^Fp       , Ss          , Ss          , Ss          , Ss          , Ss          , Ss          , Ss^Vhs      , Ss          , Ss          , Ss          
Hh          , Hh          , Hh          , Ss          , Ss          , Gs^Fp       , Ss          , Ss          , Ww          , Ww          , Gs^Fp       , Gs^Fp       , Gs^Fp       , Ss          , Ss          , Hh          , Hh          , Hh          , Hh          , Hh          , Hh          , Ss          , Ss          , Re          , Re          , Gs^Fp       , Gs^Fp       , Gs^Fp       , Gs^Fp       , Gs^Fp       , Gs^Fp       , Ss          , Ww          , Ww          , Ss          , Ss          , Ss          , Ss          , Ss          , Ss          , Ss          , Ss          
Ss          , Ss          , Ss          , Ss          , Ss          , Ss          , Ss          , Ss          , Ss          , Ww          , Gs^Fp       , Gs^Fp       , Gs^Fp       , Ss          , Hh          , Hh          , Hh          , Hh          , Ss          , Ss          , Ss          , Ss          , Ss          , Gs^Fp       , Gs^Fp       , Re          , Re          , Gs^Fp       , Gs^Fp       , Gs^Fp       , Gs^Fp       , Ss          , Gs^Fp       , Ss          , Ss          , Ch          , Ch          , Ch          , Ss          , Ss          , Gs^Fp       , Ss          
Ss          , Ss          , Ss          , Ss          , Ss          , Gs^Fp       , Gs^Fp       , Ss          , Ss          , Ww          , Ww          , Ss          , Ww          , Ss          , Ww          , Ss          , Ss          , Ss          , Ss          , Ss          , Ss          , Ss          , Ss          , Gs^Fp       , Gg^Ve       , Gs^Fp       , Gs^Fp       , Re          , Re          , Gs^Fp       , Gs^Fp       , Gs^Fp       , Gs^Fp       , Ss          , Ch          , Ch          , 1 Kh        , Ch          , Ss          , Ss          , Re          , Ss          
Ss          , Gs^Fp       , Ss          , Ss          , Ss          , Gs^Fp       , Gs^Fp       , Ww          , Ss^Vhs      , Ss          , Ss          , Ww          , Ss          , Ww          , Ss          , Ww          , Ww          , Ss          , Ss          , Ss          , Ss          , Ss          , Gs^Fp       , Gs^Fp       , Gs^Fp       , Gs^Fp       , Gg^Ve       , Gs^Fp       , Gs^Fp       , Re          , Re          , Gs^Fp       , Re          , Ww^Bw/      , Ch          , Ch          , Ch          , Re          , Re          , Re          , Ss          , Re          
Gs^Fp       , Gs^Fp       , Ss          , Ss          , Ss          , Gs^Fp       , Gs^Fp       , Ss          , Ww          , Ww          , Ss          , Ss          , Gg          , Gg          , Ss          , Ss          , Ss          , Ww          , Ww          , Ss          , Gs^Fp       , Gs^Fp       , Gs^Fp       , Gs^Fp       , Gs^Fp       , Gs^Fp       , Gs^Fp       , Gs^Fp       , Gs^Fp       , Gs^Fp       , Gs^Fp       , Re          , Ss          , Ss          , Ss          , Ss          , Ss          , Ss          , Ss          , Ss          , Ss          , Ss          
Gs^Fp       , Ss          , Ss          , Ss          , Ss          , Gs^Fp       , Ss          , Ss          , Ww          , Ww          , Ww          , Gg          , Gg          , Gg          , Ss          , Ss          , Ss          , Ss          , Ww          , Ww          , Gs^Fp       , Gs^Fp       , Ww          , Gs^Fp       , Gs^Fp       , Gs^Fp       , Gs^Fp       , Gs^Fp       , Gs^Fp       , Gs^Fp       , Gs^Fp       , Gs^Fp       , Ss          , Ss          , Ss          , Ss          , Ss          , Ww          , Ww          , Ss          , Ss          , Ss          
Gs^Fp       , Gs^Fp       , Gg^Ve       , Gs^Fp       , Ss          , Ss          , Ss          , Ss          , Ww          , Ww          , Ww          , Gg          , Gg          , Ss^Vhs      , Ss          , Ss          , Ss          , Ss          , Ss          , Ww          , Gs^Fp       , Ss^Vhs      , Ww          , Ss          , Gs^Fp       , Hh          , Gs^Fp       , Ss          , Gs^Fp       , Gs^Fp       , Ss          , Ss          , Ss          , Ss          , Gg          , Gg          , Ww          , Ww          , Hh          , Hh          , Hh          , Mm          
Gs^Fp       , Gs^Fp       , Gs^Fp       , Gs^Fp       , Ss          , Ss          , Ss          , Gg          , Ww          , Ww          , Ss          , Ss          , Ss          , Ss          , Ss          , Ss          , Ss          , Ss          , Ss          , Ww          , Ww          , Ww          , Ww          , Hh          , Hh          , Hh          , Hh          , Ss          , Ww          , Ss          , Ss          , Ss          , Gg          , Gg          , Ss          , Ss          , Ss          , Hh          , Hh          , Mm          , Mm          , Mm          
