border_size=1
usage=map

Uh          , Uh          , Uh          , Uh          , Uh          , Ms          , Ms          , Ms          , Md          , Md          , Md          , Md          , Md          , Md          , Md          , Hh^Fms      , Hh^Fms      , Hh^Fms      , Hh^Fms      , Hh^Fms      , Hh^Fms      , Gg          , Wwf         , Wwr         , Wwr         , Wwr         , Ww          , Wo          , Wo          , Wo          , Wo          , Wo          
Uh          , Uh          , Uh          , Uh          , Ms          , Ms          , Ms          , Ms          , Ms          , Md          , Md          , Md          , Md          , Md          , Md          , Hh^Fms      , Hh^Fms      , Hh^Fms      , Hh^Fms      , Hh^Fms      , Hh^Fms      , Hh^Fms      , Wwf         , Wwr         , Wwr         , Wwr         , Ww          , Wo          , Wo          , Wo          , Wo          , Wo          
Uh          , Uh          , Uh          , Uh          , Ms          , Ms          , Ms          , Ms          , Ms          , Ms          , Md          , Md          , Md^Xm       , Md          , Md          , Hh^Fms      , Hh^Fms      , Hh^Fms      , Hh^Fms      , Hh^Fms      , Hh^Fms      , Hh^Fms      , Wwf         , Wwf         , Wwr         , Wwr         , Wwr         , Ww          , Wo          , Wo          , Wo          , Wo          
Uh          , Uh          , Uh          , Uh          , Ms          , Ms          , Ms          , Ms          , Ms          , Ms          , Md          , Md          , Md          , Md          , Md          , Hh^Fms      , Hh^Fms      , Hh^Fms      , Hh^Fms      , Hh^Fms      , Hh^Fms      , Wwf         , Wwf         , Wwf         , Wwr         , Wwr         , Wwr         , Ww          , Wo          , Wo          , Wo          , Wo          
Mm          , Mm          , Mm          , Mm          , Mm          , Ms          , Mm          , Ms          , Ms          , Ms          , Md          , Md          , Md          , Md          , Md          , Hh^Fms      , Hh^Fms      , Hh^Fms      , Hh^Fms      , Hh^Fms      , Hh^Fms      , Wwf         , Wwf         , Wwf         , Wwr         , Wwr         , Wwr         , Ww          , Ww          , Wo          , Wo          , Wo          
Mm          , Mm          , Mm^Xm       , Mm          , Mm          , Mm          , Mm          , Mm          , Hh          , Hh          , Md          , Md          , Md          , Md          , Ha          , Ha          , Hh^Fms      , Hh^Fms      , Hh^Fms      , Hh^Fms      , Wwf         , Wwf         , Wwf         , Wwf         , Wwf         , Wwr         , Ww          , Ww          , Ww          , Wo          , Wo          , Wo          
Mm          , Mm          , Mm          , Mm          , Mm          , Mm          , Hh          , Hh          , Hh^Fmf      , Hh          , Hh          , Md          , Ha          , Ha          , Ha          , Ha          , Hh^Fms      , Hh^Fms      , Ai          , Ai          , Ai          , Wwf         , Wwf         , Wwf         , Ww          , Ww          , Ww          , Ww          , Ww          , Ww          , Wo          , Wo          
Mm          , Mm          , Mm          , Mm          , Hd          , Hh          , Hh          , Hh^Fmf      , Hh^Fmf      , Hh          , Hh          , Ha          , Ha          , Ha          , Ha          , Ha          , Rr          , Ai          , Ai          , Ai          , Aa          , Ai          , Ai          , Wwf         , Ww^Vm       , Ww          , Ww          , Ww          , Ww          , Ww          , Ww          , Wo          
Mm          , Mm          , Hd          , Hd          , Hd          , Hd          , Hh          , Hh^Fmf      , Hh^Fmf      , Hh          , Hh          , Ha          , Ha          , Ha          , Ha          , Ha          , Rr          , Rr          , Rr          , Ai          , Aa          , Aa          , Aa          , Ai          , Chw         , Chw         , 1 Khw       , Ww          , Ww          , Ww          , Ww          , Ww          
Hd          , Hd          , Hd          , Hd          , Hd          , Hd          , Hh          , Hh          , Hh          , Hh          , Hh          , Ha          , Ha          , Ha          , Ha          , Ha          , Re          , Rr          , Rr          , Rr          , Rp          , Aa          , Aa          , Aa          , Chw         , Chw         , Chw         , Ww          , Ww          , Ww          , Ww          , Ww          
Hd          , Hd          , Hd          , Hd          , Hd          , Hd          , Hh          , Hh          , Hh          , Hh          , Hh          , Ha          , Ha          , Ha          , Re          , Re          , Re          , Rr          , Rr          , Rr          , Rp          , Rp          , Rp          , Rp          , Chw         , Chw         , Ss          , Ww          , Ss          , Ww          , Ww          , Ww          
Hd          , Hd          , Hd          , Hd          , Hd          , Hd          , Hh          , Hh          , Gs          , Hh          , Gs          , Ha          , Rd          , Rd          , Re          , Re          , Re          , Rr          , Rr          , Rr          , Rp          , Rp          , Rp          , Rp          , Chs         , Chs         , Ss          , Ss          , Ss          , Ss          , Ss          , Ww          
Hd          , Hd          , Gg^Efm         , Hd          , Gg^Efm         , Hd          , Gg^Wm       , Hh          , Gs          , Gs          , Gs          , Rd          , Rd          , Rd          , Re          , Re          , Re          , Rr          , Re^Gvs      , Re^Gvs      , Rp          , Rp          , Rp          , Chs         , Chs         , Chs         , Ss          , Ss          , Ss          , Ss          , Ss          , Ss          
Gg          , Gg^Efm         , Gg^Efm         , Gg^Efm         , Gg^Efm         , Gg^Efm         , Gg^Wm       , Gs          , Gs          , Gs          , Gs          , Rd          , Rd          , Rd          , Re          , Re          , Re          , Re^Gvs      , Re^Gvs      , Re^Gvs      , Rp          , Rp          , Rp          , Rp          , Gg          , Chs         , Gg          , Ss          , Ss          , Ss          , Ss          , Ss          
Gg          , Gg^Efm         , Gg^Efm         , Gg^Efm         , Gg^Efm         , Co          , 3 Ko        , Co          , Gs          , Gs          , Gs          , Rd          , Rd          , Rd          , Re          , Re          , Re^Gvs      , Re^Gvs      , Re^Gvs      , Re^Gvs      , Re^Gvs      , Rp          , Gs^Fdw      , Gs^Fdw      , Gs^Fdw      , Gg          , Gg          , Gg          , Qxu^Bs|     , Ss          , Ss          , Ss          
Gg          , Gg^Efm         , Gg^Efm         , Gg^Efm         , Gg^Efm         , Co          , Co          , Co          , Gs          , Gs          , Gs          , Rd          , Rd          , Rd          , Gg          , Re^Gvs      , Re^Gvs      , Re^Gvs      , Re^Gvs      , Re^Gvs      , Re^Gvs      , Gs^Fdw      , Gs^Fdw      , Gs^Fdw      , Gs^Fdw      , Gg          , Gg          , Gg          , Qxu^Bs|     , Qxu         , Qxu         , Ss          
Gg          , Gg^Efm         , Gg^Efm         , Gg^Efm         , Gg^Efm         , Gg^Efm         , Gg^Wm       , Gs          , Gs          , Gs          , Gg          , Rd          , Gg          , Gg          , Gg          , Gg          , Hd          , Re^Gvs      , Re^Gvs      , Re^Gvs      , Ds          , Gs^Fdw      , Gs^Fdw      , Gs^Fdw      , Gs^Fdw      , Gg          , Qxu         , Qxu         , Qxu^Bs|     , Qxu         , Qxu         , Qxu         
Gg          , Gg^Efm         , Gg^Efm         , Gg^Efm         , Gg^Efm         , Gg^Efm         , Gg          , Gs          , Gg          , Gg          , Gg          , Gg          , Gg          , Gg          , Gg          , Gg          , Hd          , Hd          , Ds          , Ds          , Ds          , Gs^Fdw      , Gs^Fdw      , Gs^Fdw      , Gs^Ft       , Gg          , Qxu         , Qxu         , Qxu^Bs|     , Qxu         , Qxu         , Qxu         
Gg          , Gg          , Gg          , Gg^Efm         , Gg          , Gg          , Gg          , Gg          , Gg          , Gg          , Gg          , Gg          , Gg          , Gg          , Gg          , Gg          , Hd          , Hd          , Ds          , Dd^Dc       , Ds          , Ds          , Gg^Fet      , Gs^Ft       , Gs^Ft       , Hd          , Qxu         , Qxu         , Qxu^Bs|     , Qxu         , Qxu         , Qxu         
Gg          , Gg          , Gg          , Gg          , Gg          , Gg          , Gg          , Gg          , Gg          , Gg          , Gg          , Gg          , Gg          , Gg          , Gg          , Gg          , Hd          , Hd          , Hd          , Ds          , Ds          , Ds          , Dd^Do       , Gs^Ft       , Gs^Ft       , Hd          , Uu          , Qxu         , Qxu^Bs|     , Qxu         , Qxu         , Qxu         
Gg          , Gg          , Gg          , Gg          , Gg          , Gg          , Gg          , Gg          , Gg          , Gg          , Gg          , Gg          , Gg          , Gg          , Gg          , Gg          , Gg          , Hd          , Rd          , Hd          , Hd          , Ds          , Ds^Dr       , Ds          , Hd          , Hd          , Uu          , Uu          , Uu          , Qxu         , Qxu         , Qxu         
Gg          , Gg          , Gg          , Gg          , Gg          , Gg          , Gg          , Gg          , Gg          , Gg          , Gg          , Gg          , Gg          , Gg          , Gg          , Gg          , Gg          , Rd          , Rd          , Hd          , Hd          , Ds          , Ds          , Ds          , Hd          , Hd          , Ur          , Uu          , Uu          , Uu          , Uu          , Qxu         
Gg          , Gg          , Gg          , Gg          , Gg          , Gg          , Gg          , Gg          , Gg          , Gg          , Gg          , Gg          , Gg          , Gg          , Gg          , Gg          , Dd          , Dd          , Dd          , Rd          , Rd          , Hd          , Hd          , Hd          , Hd          , Hd          , Cud         , Ur          , Ur          , Uu          , Uu          , Uu          
Gg          , Gg          , Gg          , Gg          , Gg          , Gg          , Gg          , Gg          , Gg          , Gg          , Gg          , Gg          , Gg          , Gg          , Gg          , Gg          , Gg          , Dd          , Dd          , Dd          , Rd          , Rd          , Rd          , Hd          , Rd          , Rd          , Kud         , Cud         , Ur          , Ur          , Ur          , Uu          
Gg          , Gg          , Gg          , Gg          , Ce          , Ce          , Ce          , Gg          , Gg          , Gg          , Gg          , Gg          , Gg          , Gg          , Gg          , Gg          , Gg          , Dd          , Dd          , Dd          , Dd          , Dd^Dr       , Dd          , Rd          , Dd          , Dd          , Uu^Uf       , Cud         , Ur          , Ur^Ii       , Ur          , Ur          
Gg          , Gg          , Gg          , Ce          , Ce          , Ce          , Ce          , Ce          , Gg          , Gg          , Gg          , Gg          , Gg          , Gg          , Gg          , Gg          , Gs^Ft       , Gg          , Dd          , Dd          , Dd          , Dd          , Dd          , Dd          , Dd          , Dd          , Uu^Uf       , Uu^Uf       , Uu^Uf       , Ur          , Ur          , Ur          
Gg          , Gg          , Gg          , Ce          , Ce          , 2 Ke        , Ce          , Ce          , Gg          , Gg          , Gg          , Gg          , Gg          , Gg          , Gg          , Gg          , Gg^Fet      , Gs^Fds      , Gg          , Dd          , Dd          , Dd          , Dd          , Dd          , Qlf         , Qlf         , Uu^Uf       , Uu^Uf       , Uu^Uf       , Uu^Uf       , Uu^Uf       , Ur          
Gg          , Gg          , Gg          , Ce          , Ce          , Ce          , Ce          , Ce          , Gg          , Gg          , Gg          , Gg          , Gg          , Gg          , Chr         , Gg          , Hh^Fdw      , Gs^Fdf      , Ql          , Ql          , Ql^Bs/      , Dd          , Qlf         , Qlf         , Qlf         , Qlf         , Uh          , Uu^Uf       , Uu^Uf       , Uu^Uf       , Uu^Uf       , Uu^Uf       
Gg          , Gg          , Gg          , Gg          , Gg          , Ce          , Gg          , Gg          , Gg          , Gg          , Gg          , Gg          , Gg          , Chr         , 4 Kh        , Chr         , Gg          , Hh^Fms      , Ql^Bs/      , Ql^Bs/      , Ql          , Qlf         , Qlf         , Qlf         , Qlf         , Qlf         , Uh          , Uh          , Uh          , Uu^Uf       , Uu^Uf       , Uu^Uf       
Gg          , Gg          , Gg          , Gg          , Gg          , Gg          , Gg          , Gg          , Gg          , Gg          , Gg          , Gg          , Gg          , Chr         , Chr         , Chr         , Gs^Fp       , Ha^Fda      , Ql          , Ql          , Ql          , Qlf         , Qlf         , Qlf         , Xos         , Xos         , Xu          , Uh          , Uh          , Uh          , Uh          , Uu^Uf       
Gg          , Gg          , Gg          , Gg          , Gg          , Gg          , Gg          , Gg          , Gg          , Gg          , Gg          , Gg          , Gg          , Gg          , Gg          , Gg          , Hh^Fmw      , Gs^Fp       , Ql          , Ql          , Ql          , Qlf         , Xos         , Xos         , Xos         , Xos         , Xu          , Xu          , Xu          , Uh          , Uh          , Uh          
Gg          , Gg          , Gg          , Gg          , Gg          , Gg          , Gg          , Gg          , Gg          , Gg          , Gg          , Gg          , Gg          , Gg          , Gg          , Gg          , Gg          , Gg          , Gg          , Ql          , Ql          , Ql          , Xos         , Xos         , Xos         , Xos         , Xu          , Xu          , Xu          , Xu          , Xu          , Uh          
