border_size=1
usage=map

Qlf         , Cud         , Cud         , Cud         , Uh          , Uh          , Qlf         , Uh          , Uh          , Uh          , Uh          , Xu          , Xu          , Xu          , Xu          , Xu          , Uh          , Xu          , Xu          , Xu          , Xu          , Xu          , Uh          , Uh          , Uh          , Xu          , Xu          , Uu          , Uu          , Uu          , Uu^Vu       , Uu          , Uu          , Xu          , Uu          , Uu          , Uu          , Uu          , Uu          , Uu          , Uu          , Xu          
Qlf         , Cud         , Cud         , Cud         , 6 Kud       , Uh          , Qlf         , Uh          , Uu          , Uh          , Uh          , Uh          , Uh          , Uh          , Uh          , Xu          , Uh          , Uh          , Uh          , Xu          , Uh          , Uh          , Uh          , Uh          , Uh          , Uh          , Uh          , Xu          , Uu          , Uu          , Uu          , Uu          , Uu          , Uu          , Uu          , Uu          , Xu          , Uu          , Uu          , Uu          , Uu          , Uu          
Qlf         , Qlf         , Cud         , Uh          , Qlf         , Qlf         , Uh          , Uh          , Uu          , Uh          , Uu          , Uh          , Uu^Uf       , Uh          , Uu          , Uh          , Uu          , Uu          , Uu          , Uh          , Xu          , Uh          , Xu          , Xu          , Uh          , Uh          , Uh          , Uu^Vu       , Uh          , Uu          , Uu          , Uu          , Uu          , Uu          , Uu          , Uu          , Cud         , Xu          , Xu          , Uu          , Xu          , Xu          
Qlf         , Qlf         , Qlf         , Cud         , Qlf         , Uh          , Uu^Vu       , Uu          , Uh          , Uh          , Xu          , Uu          , Uu^Uf       , Uu^Uf       , Uu          , Uu^Vu       , Uh          , Uu          , Uh          , Uh          , Uh          , Uh          , Uh          , Xu          , Uh          , Uh          , Uh          , Uh          , Uh          , Xu          , Uh          , Uu          , Uu          , Uu          , Uh          , Uu          , Cud         , Cud         , Uh          , Uu^Vu       , Uh          , Xu          
Xu          , Qlf         , Qlf         , Cud         , Qlf         , Uh          , Uh          , Uh          , Uh          , Uu^Vu       , Cud         , Uh          , Uu          , Uu          , 5 Kud       , Cud         , Cud         , Uh          , Uh          , Uh          , Xu          , Uh          , Xu          , Uh          , Xu          , Uh          , Uh          , Xu          , Uh          , Uh          , Uh          , Uu          , Uu          , Uu          , Uu^Vu       , Uu          , Cud         , Cud         , Xu          , Xu          , Uh          , Uh          
Xu          , Ql          , Ql          , Qlf         , Qlf         , Uh          , Ql          , Uh          , Ql          , Cud         , Uu^Vu       , Cud         , Cud         , Uu          , Cud         , Cud         , Cud         , Cud         , Ql          , Ql          , Ql          , Xu          , Ql          , Xu          , Ql          , Xu          , Xu          , Uh          , Uh          , Uh          , Xu          , Uh          , Uh          , Uu          , Xu          , Xu          , Cud         , Cud         , Uh          , Uh          , Xu          , Xu          
Xu          , Ql          , Ql          , Ql          , Ql          , Ql          , Ql          , Ql          , Uu          , Ql^Bs/      , Ql          , Ql          , Ql          , Cud         , Ql          , Ql          , Ql^Bs|      , Ql          , Xu          , Xu          , Xu          , Ql          , Ql          , Ql          , Xu          , Ql          , Ql          , Xu          , Ql          , Xu          , Ql          , Xu          , Ql          , Uh          , Uh          , Uh          , 4 Kud       , Cud         , Cud         , Uh          , Ql          , Ql          
Ql          , Ql          , Ql          , Xu          , Xu          , Xu          , Xu          , Xu          , Ql          , Ql^Bs\      , Uu          , Ql          , Xu          , Ql^Bs|      , Ql          , Ql          , Ur          , Ql          , Ql          , Xu          , Xu          , Xu          , Xu          , Xu          , Ql          , Xu          , Ql          , Ql          , Uh          , Ql          , Uh          , Ql          , Ql          , Ql          , Ql          , Uh          , Ql^Bs|      , Ql          , Ql          , Ql          , Ql          , Ql          
Xu          , Ql          , Xu          , Ql          , Ql          , Ql          , Ql          , Ql          , Xu          , Uu          , Uu          , Xu          , Uu          , Uu          , Ur          , Ur          , Ur          , Xu          , Xu          , Ql          , Ql          , Ql          , Ql          , Ql          , Ql          , Ql          , Uh          , Uh          , Uh          , Uh          , Uh          , Xu          , Xu          , Ql          , Ql          , Ql          , Uu          , Ql          , Ql          , Ql          , Ql          , Xu          
Xu          , Xu          , Xu          , Xu          , Xu          , Ql          , Xu          , Xu          , Xu          , Xu          , Uu          , Uu          , Xu          , Xu          , Xu          , Ur          , Uu          , Xu          , Xu          , Xu          , Xu          , Xu          , Xu          , Xu          , Xu          , Uu          , Xu          , Uh          , Uh          , Uh          , Uh          , Xu          , Xu          , Uh          , Uh          , Ql^Bs/      , Ql^Bs|      , Ql          , Xu          , Xu          , Xu          , Ql          
Xu          , Xu          , Xu          , Xu          , Xu          , Xu          , Xu          , Xu          , Xu          , Uu          , Uu          , Uu          , Xu          , Xu          , Xu          , Xu          , Xu          , Uu          , Xu          , Xu          , Xu          , Xu          , Xu          , Xu          , Xu          , Uu          , Xu          , Xu          , Xu          , Uh          , Uh          , Uh          , Uh          , Uh          , Uh          , Xu          , Ur          , Ql          , Xu          , Xu          , Xu          , Xu          
Xu          , Xu          , Qxu         , Qxu         , Qxu         , Qxu         , Qxu         , Xu          , Uu^Vu       , Uu          , Uu          , Xu          , Xu          , Xu          , Xu          , Xu          , Xu          , Uu          , Uu          , Xu          , Xu          , Xu          , Xu          , Uu^Vu       , Uu          , Uu          , Xu          , Xu          , Xu          , Uh          , Uh          , Uh          , Xu          , Uh          , Uh          , Xu          , Ur          , Ur          , Xu          , Xu          , Xu          , Xu          
Qxu         , Qxu         , Qxu         , Qxu         , Qxu         , Qxu         , Qxu         , Qxu         , Qxu         , Uu          , Uu          , Xu          , Xu          , Xu          , Xu          , Xu          , Xu          , Xu          , Xu          , Uu          , Xu          , Xu          , Xu          , Xu          , Uu          , Xu          , Uh          , Uh          , Uh          , Uh          , Xu          , Xu          , Xu          , Uh          , Xu          , Uh          , Ur          , Ur          , Uu^Vu       , Xu          , Xu          , Xu          
Qxu         , Qxu         , Qxu         , Qxu         , Uh          , Uh          , Uu^Vu       , Qxu         , Qxu         , Qxu         , Qxu         , Qxu         , Qxu         , Qxu         , Qxu         , Xu          , Xu          , Xu          , Uu^Vu       , Uu          , Uu          , Xu          , Xu          , Uu          , Uh          , Uh          , Xu          , Xu          , Xu          , Uh          , Uh          , Xu          , Xu          , Xu          , Xu          , Ur          , Ur          , Ur          , Xu          , Xu          , Xu          , Xu          
Qxu         , Qxu         , Cud         , Uh          , Qxu         , Qxu         , Uh          , Qxu         , Qxu         , Qxu         , Qxu         , Qxu         , Qxu         , Qxu         , Qxu         , Qxu         , Qxu         , Xu          , Xu          , Uu          , Uu          , Xu          , Xu          , Uu          , Uu          , Uh          , Xu          , Xu          , Xu          , Uh          , Uh          , Xu          , Xu          , Xu          , Xu          , Ur          , Ur          , Xu          , Xu          , Xu          , Xu          , Xu          
Uh          , 7 Kud       , Cud         , Uh          , Qxu         , Qxu         , Qxu         , Uh          , Uh          , Qxu         , Qxu         , Qxu         , Qxu         , Qxu         , Qxu         , Qxu         , Qxu         , Qxu         , Qxu         , Xu          , Uu          , Uu          , Uu          , Xu          , Uu          , Uu          , Xu          , Xu          , Xu          , Xu          , Uh          , Uh          , Uh          , Xu          , Xu          , Ur          , Ur          , Xu          , Xu          , Xu          , Xu          , Xu          
Qxu         , Cud         , Uh          , Uh          , Uh          , Uu^Vu       , Uh          , Uh          , Qxu         , Uh          , Qxu         , Qxu         , Qxu         , Qxu         , Qxu         , Qxu         , Qxu         , Qxu         , Qxu         , Qxu         , Xu          , Uu          , Uu          , Uu          , Xu          , Uu          , Uu          , Xu          , Xu          , Xu          , Xu          , Uh          , Uu          , Xu          , Ur          , Ur          , Ur          , Xu          , Chw         , Xu          , Xu          , Xu          
Qxu         , Qxu         , Qxu         , Uh          , Qxu         , Qxu         , Qxu         , Qxu         , Qxu         , Uh          , Qxu         , Qxu         , Qxu         , Qxu         , Qxu         , Qxu         , Xu          , Qxu         , Uu          , Uu          , Uu          , Uu          , Uu          , Xu          , Xu          , Uu          , Uu          , Uu          , Uu          , Xu          , Uu          , Uu          , Xu          , Uu          , Ur          , Ur          , Uu          , Xu          , Chw         , Chw         , Chw         , Xu          
Qxu         , Qxu         , Qxu         , Qxu         , Qxu         , Qxu         , Qxu         , Qxu         , Qxu         , Qxu         , Uu          , Uu          , Uu          , Xu          , Xu          , Uu          , Uu          , Uu          , Uu          , Uu          , Uu          , Uu          , Xu          , Xu          , Xu          , Xu          , Xu          , Xu          , Uu          , Uu          , Uu          , Xu          , Xu          , Uu          , Xu          , Xu          , Uu          , Xu          , Chw         , Chw         , 3 Khr       , Xu          
Xu          , Qxu         , Qxu         , Qxu         , Xu          , Qxu         , Uu          , Uu          , Uu          , Uu          , Uu          , Uu          , Uu          , Uu          , Uu          , Uu^Vu       , Uu          , Uu          , Xu          , Xu          , Xu          , Uu          , Xu          , Xu          , Xu          , Xu          , Xu          , Xu          , Xu          , Uu          , Uu          , Uu          , Xu          , Uu          , Uu          , Uu          , Xu          , Xu          , Chw         , Wo          , Wo          , Wo          
Xu          , Xu          , Uu^Vu       , Xu          , Xu          , Xu          , Uu          , Xu          , Xu          , Uu          , Uu          , Uu          , Uh          , Uu          , Xu          , Uu          , Xu          , Xu          , Xu          , Xu          , Xu          , Uu^Vu       , Xu          , Xu          , Xu          , Xu          , Xu          , Xu          , Uu          , Uu          , Xu          , Xu          , Xu          , Xu          , Uu          , Uu          , Ww          , Ww          , Wo          , Wo          , Xu          , Wo          
Uh          , Uh          , Uh          , Xu          , Uh          , Xu          , Uu          , Uu          , Uu          , Uu          , Xu          , Uh          , Uh          , Uh          , Uh          , Xu          , Xu          , Xu          , Xu          , Xu          , Uh          , Uh          , Uh          , Uh          , Uh          , Xu          , Uu          , Uu          , Xu          , Uu          , Uu          , Xu          , Xu          , Xu          , Xu          , Xu          , Ww          , Wo          , Wo          , Xu          , Wo          , Xu          
Xu          , Uh          , Uh          , Uh          , Xu          , Uu          , Xu          , Uu          , Uu          , Uu          , Uu          , Xu          , Xu          , Uh          , Xu          , Uh          , Uh          , Uh          , Uh          , Uh          , Xu          , Uh          , Xu          , Uh          , Uu          , Uu          , Xu          , Xu          , Xu          , Xu          , Uu          , Xu          , Xu          , Xu          , Ww          , Ww          , Wo          , Wo          , Wo          , Wo          , Wo          , Wo          
Uh          , Uh          , Xu          , Uh          , Xu          , Uu          , Uu          , Xu          , Uu          , Xu          , Uu          , Xu          , Xu          , Xu          , Xu          , Xu          , Xu          , Uh          , Xu          , Xu          , Xu          , Xu          , Xu          , Xu          , Uu          , Xu          , Xu          , Xu          , Uu^Vu       , Xu          , Uu          , Xu          , Xu          , Uu^Vu       , Ww          , Ww          , Wo          , Wo          , Wo          , Wo          , Wo          , Wo          
Xu          , Xu          , Xu          , Xu          , Xu          , Xu          , Xu          , Uu          , Uu          , Uu          , Uu          , Uu          , Uh          , Xu          , Uh          , Xu          , Uh          , Uh          , Xu          , Xu          , Xu          , Xu          , Uu^Vu       , Uu          , Uu          , Xu          , Xu          , Xu          , Uu          , Xu          , Uu          , Uu          , Ww          , Ww          , Wo          , Wo          , Wo          , Wo          , Ww^Vm       , Wo          , Wo          , Wo          
Xu          , Xu          , Xu          , Xu          , Xu          , Xu          , Xu          , Xu          , Xu          , Uu          , Uu          , Uu          , Xu          , Uh          , Xu          , Uh          , Xu          , Uh          , Uh          , Xu          , Xu          , Xu          , Xu          , Uu          , Xu          , Xu          , Xu          , Uu          , Xu          , Uu          , Xu          , Uu          , Ww          , Ww          , Wo          , Xu          , Wo          , Wo          , Wo          , Wo          , Wo          , Wo          
Ww          , Xu          , Xu          , Xu          , Uu^Uf       , Uu^Uf       , Xu          , Xu          , Uu^Uf       , Uu          , Uu          , Uu          , Xu          , Uh          , Uu^Vu       , Xu          , Xu          , Xu          , Uh          , Uh          , Uh          , Xu          , Uu          , Uu          , Xu          , Xu          , Xu          , Uu          , Xu          , Xu          , Xu          , Uu          , Ww          , Xu          , Wo          , Wo          , Wo          , Wo          , Wo          , Wo          , Wo          , Wo          
Ww          , Xu          , Ww          , Xu          , Ww          , Ww          , Wwf         , Xu          , Wwf         , Uu          , Ww          , Xu          , Xu          , Uh          , Xu          , Xu          , Xu          , Xu          , Xu          , Xu          , Uu          , Uu          , Xu          , Xu          , Xu          , Xu          , Xu          , Uu          , Uu          , Xu          , Xu          , Xu          , Ww          , Xu          , Wo          , Wo          , Wo          , Wo          , Wo          , Wo          , Wo          , Wo          
Xu          , Ww          , Ww          , Ww          , Uu^Uf       , Xu          , Xu          , Wwf         , Uu          , Wwf         , Ww          , Ww          , Uh          , Uh          , Xu          , Xu          , Xu          , Xu          , Xu          , Xu          , Uu          , Uu          , Uu^Vu       , Xu          , Xu          , Xu          , Xu          , Uu^Vu       , Uu          , Xu          , Xu          , Xu          , Ww          , Xu          , Xu          , Wo          , Wo          , Wo          , Wo          , Wo          , Wo          , Wo          
Xu          , Xu          , Xu          , Uu^Uf       , Uu^Uf       , Xu          , Xu          , Uu          , Uu          , Uu          , Xu          , Ww          , Ww          , Xu          , Xu          , Xu          , Xu          , Xu          , Xu          , Uu          , Xu          , Xu          , Xu          , Xu          , Xu          , Xu          , Xu          , Xu          , Xu          , Uu          , Xu          , Xu          , Ww          , Ww          , Wo          , Wo          , Wo          , Wo          , Wo          , Wo          , Wo          , Wo          
Xu          , Xu          , Uh          , Xu          , Xu          , Uu^Vu       , Uu          , Uu          , Xu          , Xu          , Xu          , Xu          , Xu          , Ww          , Xu          , Xu          , Xu          , Xu          , Uu          , Uu          , Xu          , Xu          , Xu          , Xu          , Xu          , Xu          , Xu          , Xu          , Xu          , Uu          , Xu          , Ww          , Ww          , Wo          , Xu          , Xu          , Wo          , Wo          , Wo          , Wo          , Wo          , Wo          
Xu          , Uh          , Uh          , Uh          , Uu          , Uu          , Uu          , Uu          , Xu          , Xu          , Xu          , Xu          , Xu          , Ww          , Xu          , Xu          , Xu          , Xu          , Uu          , Uu          , Xu          , Xu          , Xu          , Xu          , Xu          , Xu          , Xu          , Xu          , Uu^Uf       , Uu^Uf       , Uu^Uf       , Xu          , Ww          , Ww          , Ww          , Xu          , Xu          , Wo          , Wo          , Wo          , Wo          , Wo          
Xu          , Uh          , Uh          , Uu          , Uu          , Uu          , Xu          , Xu          , Xu          , Xu          , Xu          , Xu          , Ww          , Ww          , Xu          , Xu          , Xu          , Uu          , Xu          , Xu          , Xu          , Xu          , Xu          , Xu          , Xu          , Xu          , Uu^Uf       , Uu^Uf       , Uu^Uf       , Uu^Uf       , Ww          , Ww          , Ww          , Ww          , Wwf         , Ww^Vm       , Wo          , Wo          , Wo          , Wo          , Wo          , Xu          
Xu          , Ch          , 1 Kh        , Uu          , Uu          , Uu          , Xu          , Xu          , Xu          , Xu          , Xu          , Ww          , Xu          , Xu          , Xu          , Xu          , Ww          , Ww          , Ww          , Xu          , Xu          , Xu          , Xu          , Xu          , Xu          , Xu          , Uu^Uf       , Xu          , Wwf         , Ww          , Wwf         , Ww          , Wwf         , Wwf         , Uu^Uf       , Ww          , Wo          , Wo          , Xu          , Wo          , Xu          , Xu          
Xu          , Ch          , Ch          , Uu          , Uu          , Xu          , Xu          , Xu          , Uu          , Xu          , Ww          , Ww          , Xu          , Xu          , Ww          , Ww          , Xu          , Xu          , Xu          , Ww          , Ww          , Ww          , Ww          , Xu          , Xu          , Uu^Uf       , Xu          , Wwf         , Xu          , Wwf         , Wwf         , Wwf         , Xu          , Uu^Uf       , Ur          , Xu          , Uu          , Xu          , Xu          , Xu          , Xu          , Xu          
Xu          , Ch          , Ch          , Uu          , Uu          , Uu^Vu       , Ur          , Ur          , Uu          , Uu^Uf       , Wwf         , Xu          , Ww          , Ww          , Uu^Uf       , Uu^Uf       , Uu^Uf       , Uu^Uf       , Uu          , Uu          , Uu          , Ww          , Ww          , Ww          , Wwf         , Xu          , Wwf         , Wwf         , Xu          , Xu          , Uu^Vud      , Uu          , Ur          , Ur          , Ur          , Ur          , Ur          , Uu          , Uu^Vud      , Xu          , Ur          , Xu          
Xu          , Uu^Vu       , Ur          , Ur          , Ur          , Ur          , Xu          , Xu          , Wwf         , Wwf         , Wwf         , Wwf         , Xu          , Uu^Uf       , Xu          , Xu          , Uu          , Uu          , Xu          , Xu          , Xu          , Uu          , Uu          , Wwf         , Xu          , Wwf         , Uu          , Ur          , Ur          , Uu          , Ur          , Ur          , Xu          , Xu          , Uu          , Uu          , Uu          , Ur          , Ur          , Ur          , Uu^Vud      , Ur          
Xu          , Ch          , Ur          , Ur          , Ur          , Xu          , Xu          , Xu          , Wwf         , Wwf         , Ur          , Xu          , Uu^Uf       , Xu          , Xu          , Uu          , Ur          , Ur          , Ur          , Xu          , Xu          , Xu          , Ur          , Ur          , Ur          , Uu          , Xu          , Xu          , Xu          , Xu          , Xu          , Xu          , Xu          , Xu          , Uu          , Uu          , Uu          , Uu          , Uu          , Uh          , Uh          , Uh          
Xu          , Ch          , Ur          , Ur          , Ur          , Xu          , Xu          , Ww          , Ww          , Uu^Uf       , Xu          , Ur          , Ur          , Xu          , Uu^Vu       , Ur          , Uu          , Ur          , Ur          , Ur          , Ur          , Ur          , Xu          , Xu          , Xu          , Uu          , Xu          , Xu          , Xu          , Xu          , Xu          , Xu          , Uu^Vud      , Uu          , Uu          , Uu          , Uu          , Uu          , Uh          , Uh          , Ch          , Ch          
Xu          , Xu          , Ur          , Ur          , Xu          , Uu^Uf       , Uu^Uf       , Ww          , Wwf         , Uu^Uf       , Uu^Uf       , Xu          , Xu          , Ur          , Uu          , Uu          , Xu          , Xu          , Xu          , Uu          , Xu          , Uu          , Xu          , Xu          , Xu          , Xu          , Xu          , Xu          , Xu          , Xu          , Xu          , Xu          , Uu          , Uu          , Uu          , Uu          , Uh          , Uh          , Ch          , Ch          , Ch          , Xu          
Xu          , Ur          , Ur          , Uu^Vu       , Xu          , Xu          , Xu          , Wwf         , Ww          , Uu^Uf       , Xu          , Xu          , Xu          , Xu          , Xu          , Xu          , Xu          , Xu          , Xu          , Xu          , Xu          , Xu          , Xu          , Xu          , Xu          , Xu          , Xu          , Xu          , Xu          , Xu          , Xu          , Xu          , Uu          , Uu          , Uu^Vu       , Uh          , Ch          , Ch          , Ch          , Ch          , 2 Kh        , Ch          
Xu          , Ur          , Ur          , Xu          , Xu          , Xu          , Xu          , Ww          , Xu          , Xu          , Xu          , Xu          , Xu          , Xu          , Xu          , Xu          , Xu          , Xu          , Xu          , Xu          , Xu          , Xu          , Xu          , Xu          , Xu          , Xu          , Xu          , Xu          , Xu          , Xu          , Xu          , Uu          , Xu          , Xu          , Xu          , Ch          , Xu          , Xu          , Xu          , Xu          , Ch          , Ch          
