border_size=1
usage=map

Gs^Fp       , Ds          , Wo          , Wo          , Ds          , Gs^Fp       , Gs^Fp       , Gg          , Gg          , Gs^Fp       , Ww          , Gs^Fp       , Gg          , Gg          , Gg          , Gg          , Gg          , Gs^Fp       , Gs^Fp       , Gs^Fp       , Gs^Fp       , Gg          , Gs^Fp       , Gg          , Gs^Fp       , Gg          , Gs^Fp       , Gg          , Gs^Fp       , Gg          , Gs^Fp       , Gs^Fp       
Ss          , Gs^Fp       , Ds          , Ds          , Ds          , Ss          , Gs^Fp       , Gs^Fp       , Gs^Fp       , Gs^Fp       , Ww          , Gs^Fp       , Gs^Fp       , Ce          , Ce          , Ce          , Gs^Fp       , Gs^Fp       , Gg          , Gg          , Gg          , Gg          , Gg          , Gs^Fp       , Gs^Fp       , Gs^Fp       , Gg          , Gs^Fp       , Gs^Fp       , Gg          , Gs^Fp       , Gs^Fp       
Ss          , Ss          , Gs^Fp       , Gg          , Gg          , Gs^Fp       , Gs^Fp       , Ds          , Ds          , Ss^Vhs      , Ww          , Gs^Fp       , Gs^Fp       , Ce          , 1 Ke        , Ce          , Gg          , Gs^Fp       , Gs^Fp       , Gg          , Gg          , Gg          , Gg          , Gs^Fp       , Gs^Fp       , Gs^Fp       , Gs^Fp       , Gg          , Gg^Ve       , Gg          , Gs^Fp       , Gg          
Gs^Fp       , Gs^Fp       , Gs^Fds      , Gs^Fds      , Gs^Fds      , Gs^Fds      , Gs^Fds      , Ds          , Wo          , Ss          , Ww          , Gs^Fp       , Gs^Fp       , Gs^Fp       , Ce          , Re          , Gg          , Gg          , Gs^Fp       , Gg          , Ce          , Ce          , Ce          , Gg          , Gg          , Gs^Fp       , Gs^Fp       , Gs^Fp       , Gs^Fp       , Gs^Fp       , Gs^Fp       , Gg          
Gs^Fds      , Gs^Fds      , Gs^Fds      , Gg          , Gs^Fds      , Gs^Fds      , Gs^Fds      , Ds          , Wo          , Ss          , Ww          , Gs^Fp       , Gs^Fp       , Gs^Fp       , Gg          , Re          , Gg          , Gg^Vh       , Re          , Re          , Ce          , 2 Ke        , Ce          , Gg          , Gg          , Gg          , Gs^Fp       , Gs^Fp       , Gg          , Gs^Fp       , Gs^Fp       , Ds          
Gg          , Gs^Fds      , Gs^Fds      , Gg          , Gs^Fds      , Gg          , Gs^Fds      , Gs^Fds      , Gs^Fds      , Gs^Fp       , Ww          , Ww          , Ww          , Gs^Fp       , Gg          , Re          , Re          , Re          , Gg          , Gg          , Gg          , Ce          , Gg          , Gg          , Gg          , Gg          , Gs^Fp       , Gg          , Gs^Fp       , Gs^Fp       , Ds          , Wo          
Gg          , Gs^Fds      , Gs^Fds      , Gg          , Gg          , Gg          , Gg          , Gs^Fds      , Gs^Fds      , Gs^Fp       , Gs^Fp       , Ww          , Ww          , Gg          , Gg          , Gg          , Re          , Gg          , Gg          , Gg          , Gg          , Gg          , Gg          , Gg          , Gs^Fp       , Gs^Fp       , Gg          , Gs^Fp       , Gg          , Gg          , Ds          , Ds          
Gg          , Gs^Fds      , Gs^Fds      , Gs^Fds      , Gg          , Gg          , Gg          , Gs^Fds      , Gs^Fds      , Gg          , Ww          , Ww          , Ww          , Ww          , Hh          , Gg          , Re          , Gg          , Gg          , Gg          , Gg          , Gg          , Gg          , Gg          , Gs^Fp       , Gg          , Gg          , Gs^Fp       , Gg          , Gs^Fp       , Ds          , Gg          
Ds          , Gg          , Gs^Fds      , Gg          , Gg          , Gg          , Gg          , Gs^Fp       , Gs^Fp       , Ww          , Wo          , Wo          , Ww          , Ww          , Ww          , Re          , Gg          , Gs^Fp       , Gs^Fp       , Gg          , Gg          , Gs^Fp       , Gs^Fp       , Gs^Fp       , Gg          , Gs^Fp       , Gg^Ve       , Gs^Fp       , Gs^Fp       , Gs^Fp       , Ds          , Gg          
Ww          , Gg          , Gg          , Gs^Fds      , Gg          , Gg^Vh       , Gs^Fp       , Gg          , Gs^Fp       , Ww          , Ww          , Wo          , Ww          , Mm^Vhh      , Ww          , Re          , Gs^Fp       , Ss          , Gg          , Gg          , Gg          , Gs^Fp       , Gs^Fp       , Gs^Fp       , Gg          , Gs^Fp       , Gs^Fp       , Gs^Fp       , Gg          , Gs^Fp       , Ds          , Gs^Fp       
Ww          , Ww          , Ww          , Ww          , Ds          , Gg          , Gg          , Gg          , Gg          , Ww          , Ww          , Ww          , Ww          , Ww          , Hh          , Re          , Gg          , Ss          , Gs^Fp       , Gg          , Gs^Fp       , Gs^Fp       , Gs^Fp       , Gg          , Gs^Fp       , Gg          , Gs^Fp       , Gg          , Gs^Fp       , Gs^Fp       , Ds          , Gs^Fp       
Wo          , Ww          , Wo          , Ww          , Ww          , Ds          , Ds          , Gg          , Gs^Fp       , Gg          , Gs^Fp       , Hh          , Mm          , Hh          , Gs^Fp       , Re          , Gg          , Gs^Fp       , Gg          , Gg          , Gs^Fp       , Gg^Ve       , Gs^Fp       , Gs^Fp       , Gs^Fp       , Gg          , Gg          , Gg          , Gg          , Gs^Fp       , Gs^Fp       , Gs^Fp       
Wo          , Wo          , Wo          , Wo          , Wo          , Ww          , Ww          , Ds          , Gg          , Gg          , Gs^Fmw      , Gs^Fp       , Hh          , Gs^Fp       , Re          , Re          , Re          , Gs^Fp       , Re          , Gg          , Gs^Fp       , Gs^Fp       , Gs^Fp       , Gs^Fp       , Hh          , Hh          , Gg          , Gg          , Gg          , Gg          , Gs^Fp       , Gs^Fp       
Ww          , Ww          , Ss          , Ww          , Ss          , Ss          , Ss          , Ss          , Ss          , Ss          , Gg          , Gs^Fmw      , Gs^Fmw      , Re          , Gg          , Gg          , Gg          , Re          , Gs^Fp       , Re          , Re          , Gs^Fp       , Gg          , Gs^Fp       , Hh          , Hh          , Hh^Fdw      , Hh^Fdw      , Gg          , Gg          , Gg          , Gs^Fp       
Ds          , Ss          , Ss          , Gg          , Ss          , Ds          , Ds          , Gg          , Gg          , Ss          , Ss          , Gg          , Rr          , Rr          , Gg          , Gg          , Gg          , Gg          , Gs^Fp       , Gs^Fp       , Gs^Fp       , Re          , Gg          , Gg          , Hh          , Hh          , Hh          , Hh^Fdw      , Hh^Fds      , Gg          , Gg          , Gs^Fp       
Ss          , Ss          , Ss          , Ss          , Ss          , Ds          , Gg          , Gg          , Gg          , Gg          , Rr          , Ss^Bw/      , Gs^Fmw      , Gs^Fdw      , Gg^Ve       , Gs^Fp       , Ss          , Gg          , Ss          , Gs^Fdw      , Gg          , Re          , Gg^Vh       , Gg          , Gg          , Hh          , Hh          , Hh          , Hh^Fds      , Gg          , Gg          , Gs^Fp       
Ss          , Ss          , Ss          , Ss^Vhs      , Ds          , Ss          , Gg          , Gg          , Rr          , Rr          , Gg          , Ss          , Gg          , Gs^Fdw      , Gs^Fmw      , Gs^Fp       , Gs^Fp       , Ss          , Ss          , Gs^Fdw      , Gg          , Re          , Re          , Gg          , Gs^Fdw      , Gg^Vh       , Hh          , Hh          , Hh^Fds      , Ss          , Gg          , Gs^Fp       
Ss          , Ss          , Ss          , Ds          , Ds          , Gg          , Gg          , Rr          , Ss          , Gg          , Gg          , Ss          , Ss          , Ds          , Gg          , Ds          , Gs^Fdw      , Gs^Fdw      , Ss          , Gs^Fdw      , Gg          , Gg          , Re          , Gg          , Gs^Fdw      , Gs^Fdw      , Gs^Fdw      , Hh^Fds      , Gg          , Ss          , Ss          , Gs^Fp       
Ss          , Ss          , Ss          , Ds          , Gg          , Gg          , Rr          , Ss          , Ss          , Gg          , Gg          , Ds          , Ss          , Ss          , Ds          , Ds          , Ds          , Gs^Fdw      , Ss          , Ss          , Ds          , Ds          , Gg          , Re          , Gg          , Gg          , Ss          , Hh^Fdw      , Ss          , Gg          , Gg          , Ss          
Gg          , Ss          , Gs^Fdw      , Gg          , Rr          , Rr          , Ds          , Ss          , Ds          , Ds          , Ds          , Ds          , Ss          , Ss          , Ds          , Ds          , Gg          , Ds          , Ds          , Ss          , Ss^Vhs      , Ww          , Ds          , Re          , Gg          , Gg          , Ss          , Hh^Fdw      , Hh^Fdw      , Ss          , Ss          , Ss          
Gg          , Gg          , Gg          , Gg          , Rr          , Rr^Vd       , Ds          , Ss          , Ss          , Ss          , Ss^Vhs      , Ss          , Ss          , Ss          , Ds          , Ds          , Gg          , Gg          , Ds          , Ss          , Ss          , Ss          , Ds          , Re          , Re          , Gg          , Gg          , Gg          , Gg          , Gg          , Gs^Fdw      , Gs^Fp       
Gg          , Gg          , Gg          , Gg          , Rr          , Gg          , Ds          , Ss          , Ss          , Ss          , Ss          , Ss          , Ss          , Ss          , Ds          , Gg          , Chs         , Ds          , Ds          , Ss          , Ss          , Ss          , Ds          , Gg          , Re          , Ch          , Ch          , Ch          , Gg          , Gs^Fdw      , Gs^Fdw      , Gs^Fp       
Rr          , Gg          , Gg          , Ch          , Ch          , Ch          , Gg          , Ss          , Ss          , Ss          , Ss          , Ss          , Ss          , Ss          , Chs         , Chs         , 5 Khs       , Ww          , Ss          , Ss          , Ss          , Ww          , Ds          , Gg          , Gg          , Ch          , 3 Kh        , Ch          , Re          , Gg^Ve       , Gs^Fp       , Gg          
Rp          , Rr          , Rr          , Ch          , 4 Kh        , Ch          , Gs^Fp       , Ss          , Ss          , Gs^Fdw      , Ds          , Ds          , Ds          , Ss          , Ss          , Chs         , Chs         , Chs         , Wo          , Ss          , Ss          , Ww          , Ds          , Ds          , Gg          , Gg          , Ch          , Gg          , Gg          , Re          , Re          , Ds          
Rp          , Rp          , Rr          , Rd          , Ch          , Rp          , Rp          , Gg          , Gg          , Gs^Fdw      , Gs^Fdw      , Gs^Fdw      , Ds          , Ss          , Ss          , Wo          , Wo          , Ss          , Ss          , Ss          , Ss^Vhs      , Ss          , Ss          , Ds          , Ds          , Gg          , Gg          , Gg          , Gg          , Gg          , Ds          , Re          
Rp          , Rp          , Rr          , Rd          , Rp          , Rp          , Rp          , Gg          , Gg          , Gs^Fdw      , Gs^Fdw      , Gs^Fdw      , Gg^Ve       , Ds          , Ss          , Ss          , Ss          , Wo          , Ss          , Wo          , Wo          , Ss          , Wo          , Ww          , Ds          , Ds          , Ss          , Ds          , Ds          , Ds          , Gg          , Re          
Rp          , Rp          , Rr          , Rd          , Rr^Vd       , Rp          , Rp          , Gg          , Gs^Fmw      , Gs^Fdw      , Gs^Fdw      , Gs^Fdw      , Gs^Fp       , Ds          , Ww          , Ww          , Ss          , Wo          , Ss          , Ww          , Ss          , Ss          , Wo          , Wo          , Ss          , Ss          , Ww          , Ss          , Ss          , Ss          , Gg          , Gg          
Rp          , Rp          , Rp          , Rd          , Rp          , Rp          , Gs^Fmw      , Gs^Fmw      , Gs^Fmw      , Gs^Fdw      , Gs^Fdw      , Gs^Fdw      , Gs^Fp       , Gg          , Ds          , Ds          , Ss          , Ss          , Ww          , Ss          , Ss          , Ss          , Ss          , Ss          , Ss          , Ss          , Ss          , Wo          , Ss          , Ww          , Gg          , Gg          
Rp          , Rp          , Rp          , Rd          , Rp          , Rp          , Rd          , Rd          , Rp          , Gs^Fdw      , Gs^Fdw      , Gs^Fdw      , Rp          , Gg          , Gg          , Ds          , Ww          , Ss          , Ss          , Ds          , Ds          , Ds          , Ds          , Ds          , Ds          , Ss          , Ss          , Ss          , Ss          , Ss          , Ds          , Gg          
Rp          , Rp          , Rp          , Rd          , Rd          , Rd          , Rp          , Rr          , Rr          , Rp          , Rp          , Rp          , Rp          , Gg          , Gg          , Ds          , Ww          , Ss          , Ds          , Ds          , Gg^Ve       , Ss          , Gs^Fp       , Gg          , Gg          , Ds          , Ds          , Ww          , Ss          , Ss          , Ds          , Gg          
Rp          , Rp          , Rp          , Rp          , Rp          , Rd          , Rp          , Wo          , Ds          , Rr          , Rp          , Rp          , Gg          , Gg          , Gg          , Ds          , Ds          , Gg          , Ds          , Gg          , Ss          , Ss          , Gg          , Gg          , Gg          , Gg          , Ds          , Ds          , Ss          , Ss          , Ss          , Ds          
Rp          , Rp          , Rp          , Rp          , Rp          , Rd          , Ds          , Wo          , Ds          , Rr          , Gg          , Gg          , Gg          , Gg          , Gg          , Gg          , Gg          , Gg          , Gg          , Gg          , Gs^Fp       , Gs^Fp       , Gg          , Gg          , Gg          , Gg          , Gg          , Ds          , Ww          , Ss          , Ss          , Wo          
